a-uw-a, auwi-a	awfa
ab+ar+i-ne, ab+ar+i-ne-e	abarri
ab+ar+i=m	abarim
ab+iġ+ar+i-ne-ve-ne-e=lla	abiġarrivenella
abal+ġe	abalġi
abal+ġe-a=d	abalġad
abal+ġe-āe	abalġāe
abal+ġe-āi	abalġāi
abi-iffe-až	abibaž
abi-ne-ē, abi-nē	abinie
abri	ābri
abri-i-āž-e	abriāži
abri-ā=m	abrām
abri-ī-da	abrīda
abundi-šši	abundišši
abāri	abāri
ad+a+šše	adašši
ad+a+šše-ne-e	adaššene, adaššīni
ad+a+šše-ve	adaššībi
ad+am+ġe	adamġi
ad+ašt+a+že-a	adaštaža
ad+mi-ne-e	adminie
ad+ā+ni	adāni
ad+ā+ni-i-aš-ta	adaniašta
ad-a=l, ade-a=l, adāl	adal
ad-e, ad-e, ade	ade
ad-i, ade, adi	adi
ad-ē=ma, ade=ma	adēma
adāl-ne-ē=lla, adāl-nē-ž=lla, adāl-nē=lla	adāllēlla
adīr+ġe-a	adīrġa
ag+a+šše, ag-a-šše	agašši
ag+ar+ġ-o, ag+ar+ġ-u	agarġu
ag+ūr+ni-a	agūrna
ag-a, ag-a, agi-a, agi-a	aga
ag-a-b	agab
ag-a-b=ma	agappa
ag-i, ag-i, agi, agi	agi
ag-i-b	agib
ag-i-re-ne-ve	agirinibi
ag-id-en	agiden
ag-id-o	agidu
ag-id-ō-re	agidōri
ag-o-m, ag-o=m, ag-u=m	agum
ag-o-m=ma, ag-o=ma, ag-u+ma+i, agumi-a	aguma
ag-o=lla, ag-u=lla, aguli-na	agulla
ag-o=nna	agunna
ag-ol-ūw-a	agulūwa
ag-u+m+aī=m	agumaīm
ag-ō-m-ā=lla	agūmālla
ag-ō=lla, ag-ū=lla, aguli-na, agūlli-a	agūlla
ag-ōž-a	agōža
ag-ōž-i	agōži
ag-ōž-ā	agōžā
aga-ve	agāve
aga-vē-na-āž-a	agabēnāža
ago-da	aguda
ago-ž	agōž
ai	ai, āi
ai=m	aīb
ai=m=ān, ai=mān	aimān
ai=ma	aima, ema, āima
ai=mma	aīmma
ai=n	aīn
aia	aia
aianguri-n	aiangurin
aigaldu-da	aigalduda
aigaldu-va	aigalduba
aiu-da	aiuda
aiu-va	aiwpa
aiu-ve	aiwpi
akk+ade-ne, akk+ade-ne-e	akkadeni
al+i+pte-i-až-a=l	aliptiažal
al+il+an-o-m	alilanum
al+ipš+i	alipši
al+o+bade-na-až-a	alubadinaža
al+o+re	alōri, alūri, ālōri
al+o+re-na	alurina, alūrina
al+u+b+a+sḫi-ne, al+u+b+a+sḫi-ne-e	alubasḫini
al+u+mb+a+sḫe	alumbasḫi
al+ā+že, alāže	alāži
al-d-i-āi, ald-i-āi, aldi-āi, aldā+i	aldāi
al-i-kki	alikki
al-ol-d-a	alulda
al-ol-ū	alulū
al-u+m+ai	alummai
al-u+m+ai, al-u+m+āi	alummāi
al-u+m+ai-n, alu-m+ai-n	alumain
al-u+m+aī-n	alumaīn
al-u+m+āi-n, alu-m+ai-n, alu-m+āi-n	alumāin
al-umme-a	alumma
al-umme-ne, al-umme-ne-e	alummini
al-ōl-a-šše	alōlašši
al-ū+m+āi-n	alūmāin
alalu-ž	alaluž
alami-ož	alamuž
ald-a, aldi-a	alda
all+ī+ġe-a, all-īġ-a	allīġa
alla+n+o+ḫḫe	allanōḫḫi
alla+n+o+ḫḫe-ne-va	allanuḫḫinia
alla+ni	allāni
allanzō=n	allanzōn
allum+āde-a, allumi-ā=tta	allumāda
alu-m+ai	alumai
alu-m+ai, alu-u+m+ai	aluma
alu-m+aē	alumē
alu-m+āi	alumāi
alu-m+āī-n	alumāīn
alu-ušt-i	alušti
alu-ī-b	aluwīb, aluīb
alu-ūšt-i	ālūšti
alulbi	alulbi
alv+o+vade	alvovade
alāli-ae	alālae
alē-a-b	aliab
alē-ō-m	alēōb
alġ-i, alġi	alġi
alġi	ālġi
am+a+nni-ne-va	amanniniba
am+o+mi-ā=m	amumām
am+o+mi-ā=v	amōmāb
am+ud-ō-bade, am-ud-ō-bade	amudōbadi
am+ān+umi-a=l, am-ān-o-m-a=l	amānumal
am-ar-ill-ō-m	amarillōm
am-ašt-ed-a, am-ašt-ed-a	amašteda
am-i, āmi	āmi
am-i-l-ānni	amelānni
am-o-l-ēž	amulēž
am-ol-ūd-ō-m	amulūdōm
am-ud-o-m	amudum
am-ō-ēn	amuwīn
am-ōd-o-m	amōdum
am-ōl-ud-o-m	amōludum
am-ōl-ud-ō-m	amōludōm
am-ōž-a	amōža
amarikkuwa-ne-n	amarikkuwanin
amb+a+že-a	ambaža
amissadu-ž	amissaduž
amm+ož+ikk+o+nni	ammužikkunne
amm+u+mmi, amm-umme	ammummi
amm+u+mmi-nē-va	amūminēva
amm-ed-i	ammidi
amm-ed-ō	ammidū
amm-i-en	ammen
amm-o-m	ammum
amm-ož-i=ma	ammužima
amm-ēd-a	ammēda
amm-ī-b	āmmīb
amm-ō-m	āmmōm
ammatte	ammatti
ammatte-na	amattena, amāttīna
ammurami	ammurami
amīri	amīri
an+an+ar+i+ški-ne-ve-āe	ananariškinibāe
an+an+ar+i+ški-ni-ve-āe	ananareškinibāe
an+an+e+šḫe-ia-ne	ananešḫiani
an-ašt-i-kki	anaštikki
an-aḫḫ-ož-ill-i-ae	anaḫḫužellae
an-i-kki	anikki
an-z-oš=nna	anzušša
ana-o-l-ēž	anaulēž
anagi-na	anagina
anam=ma	anamma
anammi	anammi
anammi=mma	anammimma
anammi=nna	anamminna
andi	andi
andi=lla=m	andillam
ane-ne, ane-ne-e	aninie
ani	ani
ani-ne-ve, anni-ve, annivi	annivi
ani-ne-ž	ānnež
anni	anni
anni=l	annel
anni=m	annim
anz+angi-īē-ž	anzangiēž
anz+i+ġe-i-až	anziġiaž
anz-a=mma, anzi-a=mma	ānzamma
anz-o, anz-u	anzu
anz-ī=ma, anzi-ī=ma, anzi=ma	anzīma
anzi-da	ānzida
anzi-ne	anzini
aoli-ž	auliž
app+a+šše, app-a-šše, tupp+a+šše, tupp-a-šše, umb+a+šše, umb-a-šše	umbašši
appide	appide
appubi-n, tuppubi-n, umbubi-n	appubin
apsižnā-ġe	apsižnāġi
apsu-we-ne-n	apsōenin
apše	āpši
apše-na	apšena
apše-ne-ve	apšeneve
apše-ne-ž	apšēniž
ar+e+šše-a=l, ar-i-ež-a=l	areššal
ar+i+re	arire
ar-am-d-ō-m	aramdōm
ar-i, ar-i, ar-i, ari, āri	ari
ar-i, ari, āri	āri
ar-i-a-mma	ariamma
ar-i-an	arian
ar-i-l-eva-ž	ārrivaž
ar-o	aru
ar-o-re	aruri
ar-ol-i-b	arulib
ar-ol-i-le, ar-ull-i, aruli-ne, aruli-ne-e	arulli
ar-ol-i=m	arulim
ar-ol-o-šše-na	aruluššina
ar-ol-āw-ž	arulāuž
ar-ož-ill-i-āi=m	aružellāim
ar-ōl-aw-ž	arōlauž
ar-ōl-aw=nna	arōlawunna
ar-ōl-u-d-a, ar-ōl-ud-a	arōluda
ar-ōl-ull-o-m	arōlullub
ar-ōl-āw-ž	arōlāuž
ar-ōž-o	arūžu
ar-ōž-o-šše	arūžušši
ar-ūl-āw-ž	arūlāuž
aranziġō-va	aranziġōba
arb+ar+i-ra	arbarra
ard+o+ġe-ne-ž	arduġiniž
ard-ūr-i, ardūri	ardūri
arde	arde, ardē
arde, arde-i	ārdi
arde-a	arda
arde-i-ve-ne-š=nna	ārdibinešša
arde-iffo-š=nna	ārdivošša
arde-n, arde=n	ardēn
arde-ne, arde-ne-e	ardeni, ārdēni
arde-ne-e=n, arde-ne-n, arde-ne=n	ardinin
arde-ne-ve-na	ārdenibina
arde-ve-āi	ardebāi
arde-ī-dan	ārdīdan
arde-ī-dan〈〈i〉〉	ārdīdani
arde-ī=ma	ārdīma
arde=ma	ārdima
ari-ī-ve=n, arīvi-n, āri-ī-ve=n	arīvin
arib.ebla-ž	aribiblaž
arili-f-fa, arili-iffe-a	ariliffa
arm+i+mmi	armimmi
arm-o-ež, armi-ož	armuž
arni	arni, ārni
arni-a	arna
arni-āi	arnāi
aruwallāe-na	aruwallāena
aruwallāe-na=ma	aruwallāenama
arāgi	arāgi
assusḫi	assusḫi
assusḫi-a	assusḫa
assīri	azīri, āssīri
assīri, aziri	aziri
att+o+bade-ne-ž	attubadenež
att-an-ō-eva	attanōva
atta+i	attāi
atta+i, atta+i-i	attai
atta+i-da	attaida
atta+i-i-ve, atta+i-ve	attaivi
atta+i-i-ve-ne-e, atta+i-ve-ne-e	attaebini
atta+i-i-ve-ne-š=nna, atta+i-ve-ne-š=nna	attaibinešša
atta+i-p-pe-na-āž-a	attaippināža
atta+ni	attāne
atta+ni=ma	attānima, āttanima
atta-ž	ādaž
atḫalve	atḫalve
audalumma=n	awtaluman, awtalumman
audūi	awtuwi
av+al+i-ne-ve-ne-a	avallivena
av+al+ġe	avālġi
av+al+ġe-a	avalġa
av-a, avi-a, avi-a	ava
av-ašt-i-ež	avaštiž
av-āšt-o-m	avāštum
avari-na-aš-ta	avarrašta
avari-ne, avari-ne-e	avarri
avari-ne-ve	avarribi
avari-ne-ve-na	avarribina
avari-ne-ē, avari-nē	avarrie
ave-až-a	aveaža, aveiaža
ave-až-a, avi-i-až-a	abiaža
ave-da	aveda
ave-na	avena
ave-š=d	abēd
ave-š=nna=m, aēšši-a=m	aēššam
ave-š=nnā	abiššā
ave-š=tilla	abēdilla
ave=ma	abima
avi	appi
avi+n	avīn
avi+n, avi-i-n, avi-n, avi=n	abin
avi+n, avi-n	avin
avi+n=am	abinam
avi, avi	abi, avi
avi, avi, avi	āvi
avi, avi, avi, āb-i, ābi	ābi
avi-i-da	avida, ābida
avi-i-va	*abiva
az+al+di-a, az-al-d-a	azalda
az-al-d-i-le	azaldili
az-al-d-ēd-a	azaldēda
az-al-i-le=n, azali-ne-e=n, azali-ne-n, azali-ne=n, azalli=n	azallin
az-am-ar-o-l-ēž	azamaruliēž
az-āšt-o-m	azāštum
azallae-ne-n	azallaenen
azusḫi	azusḫi
azusḫi-a	azusḫa
aġarri, aġri-ne	aġarri
aġr+i+nni-ne-ve-ne-da	aġrinninibinida
aġr+o+šḫe-ne	aġrušḫini
aġri	āġri
aġri-a	āġra
aġri-b	āġrib
aġri-da=l, aġri-i-da=l	āġridal
aġri-ne-ve	aġarribi
aġri-ne-ve-na-āž-a	aġarribināža
aġri-ne-ve-āe	aġarribāe
aġri-ne-ž	aġarrež
aġri-nē-va	aġarrēba
aġri-nē-ve-ož	aġarrēbuž
aġri-nē-ž=l	aġarrēl
aġri-ve-ož	āġribuž
aġri-āi	āġrāi
aġri-āi=d, aġrā-i=d	aġrāid
aġrā-i-lē	āġrāilī
aġui-na	aġuina
aō	au, āu
aō=l	aōl
ašk-i-le	aškili, āškili
ašk-ō-l-āe	aškōlāe
ašt+o+ḫḫe	āštuḫḫi
ašt+o+ḫḫe-na	aštuḫḫina, āštuḫḫēna
ašt+o+ḫḫe-na-až-e-āi	aštuḫḫinažāi
ašt+o+ḫḫe-na-až-ož	aštuḫḫinažuž
ašt+o+ḫḫe-na-āž-a	aštuḫḫināža
ašt+o+ḫḫe-na-āž-ož	aštuḫḫināžuž
ašt+o+ḫḫe-āe	aštuḫḫāe
aštaga-da=m	āštagādab
aštaga-ve	aštāgabi
ašḫ+ašt+a+ḫḫe, ašḫ+ašt+aʾe	ašḫaštaġe
ašḫo	ašḫu, āšḫu, āšḫō
ašḫo, āšḫ-ō	ašḫō
ašḫo-da=an, ašḫo-da=n, ašḫo-dan	ašḫudan
ašḫo-i-dan	ašḫuidan
ašḫo-n, ašḫo=n, ašḫo=n	āšḫun
ašḫo-n=an, ašḫo=n=an	ašḫōnan
ašḫo-ne-e=lla, ašḫo-ne=lla	ašḫunilla
až+arb+a+šše-na	ažarbaššina
až+i+ġe	ažiġi
až+oġi-ne-e	ažōġini, ažūġeni
až+oġi-ne-ve-a	ažuġiniva
až+oġi-ne-ž=l	ažōġinel
až+oġi-nē-ž=l	ažōġinēl
až+ož-ill-and-i-n, až+ož-ill-and-i=n	ažužellandin, ažōžellandin, ažōžillandin
až+ō+re	ažuri, ažōri, ažūri, āžōri
až+ō+re-i-ž, až+ō+re-ž	ažurež
až-amm-o, až-amm-u	ažammu
až-an-o-m	ažanub
až-ašt-ed-ōw	ažaštedō
až-ašt-i-b	ažaštib
až-ašt-i-le=m, až-ašt-il-i-b	ažaštilib
až-i-a	ažia
až-o-l-ai-n, až-o-l-ai=n	ažulain
až-ān-ēd-āw	ažānēdāw
až-ōl-a	ažōla
až-ōġ-i-ež, ažōġi-i-ž, ažōġi-ž	ažōġiž
ažamri	ažamri
aži-o-l-ai, ažiuli-ai	ažiwlai
aži-ā=l	ažāl
ažmo.nigalō=n	ažmunigalōn
ažugali-nē-ne, ažugallē-ne, ažugallē-ne-e	ažugallēni
aʾ-ašt-ed-aw	aġaštedab
aʾ-ašt-et-t-a, aʾ-ašt-i=tta	āġaštetta
aʾ-āšt-ed-aw	aġāštedab
aʾ-āšt-ed-o	aġāštedu
ebi-āe	ebāe
ebāni	ebāni
ed-a, edi-a, ide-a	eda
ed-o, ed-u	ēdu
ed-o-kko	edukku
eg+o+nni, eg+o+nni-ne, eg+o+nni-ne-e	egunni
eg+o+nni-a, eg+o+nni-na	egunna
eg+o+nni-ne-n	egunninin
eg+o+nni-ž	egunniž
eg+o+šš-i, eg+o+šše	egušši
eg+o+šš-ill-and-i-n, eg+o+šš-ill-and-i=n	eguššellandin
eg+o+šš-o-ež	eguššuž
eg+o+šš-o-l-āe-ž	eguššulāež
eg+o+šš-o-l-āi, eg+o+šš-ol-i-āi	eguššulāi
eg+o+šš-o-l-ēž	eguššulēž
eg+o+šš-ož-ill-and-i-n, eg+o+šš-ož-ill-and-i=n	eguššužilandin
eg+o+šš-u+m+ae=lla	eguššumaella
eg+o+šš-umme	eguššummi
eg+o+šš-ōl-a	egōššōla
eg+o+šše-na	eguššina
eg+o+šše-na-až-a	eguššinaža
eg+o+šše-na-až-ož, eg+o+šše-na-āž-ož	eguššinažuž
eg+o+šše-na-āž-ož	eguššināžuž
eg+o+šše-āe	eguššāe
eg+o+šše-āi	eguššāi
eg+ud+ut+ki	egudutki, igudutki
eg+ō+ni-a, eg-ōn-a	egōna
eg-i, eg-i, egi, egi, egi	egi
ege+nni-n, egi-ne-e=n, egi-ne-n	egennin
ege+nni-ne-ž	eginniniž
egi, egi, egi, ig-i, igi	igi
egi-ai	egai
egi-da, egi-i-da	igida
egi-i-až-a=ma	igiažama
egi-i-až-ā=ma	igiažāma
egi-na, egi-na	egina
egi-na-āž-ož, egi-na-āž-ož	egināžuž
egi-na-āž-ož, igi-na-āž-ož	igināžuž
egi-ne, egi-ne, egi-ne-e, egi-ne-e	egini
egi-ne-e	egēni, igēni
egi-ne-e=ma	igēnema
egi-ne-ž	eginiž
egi-nē-n, ēkke-nē-n	ēkkinēn
egi-āe	egāe
egi-āi	egāi
egib-id-o	egiptu
egužri	egužri
ela-na-až-a, eli-na-až-a, ell+a+že-a	ellaža
ela-ve-ae, elabi-ae	elabae
elami-nē-ve	elaminēve
ele-ne-vā=d	elinibād
eli-a	ela
eliški-ae=lla	eliškaella
elm+ir+ġe	ēlmirġi
elm+ir+ġe-na	elamirġena
elm+ē+ġe	elmēġi
elmi	elmi
elmi-na	ēlmina
elmi-ne-da	elminida
elmi-āi	elmāi
elōruli-a	elōrula
eman+že	emašše
eman+že-ne, eman+že-ne-e	emaššeni
eman+že-ne-va	ēmmanzeneva
en+ar+a+že-ae	enarāžae
en+ar+a+že-āe	enaražāe
en+ar+ġe-a=lla	enarġalla
en+i+tḫ+ar+i-na	enitḫarra
en+ud+ōbi-n, en+ud+ōbi=n, en+ud-ō-va-en, enudōbi=n	enudōbin
en+zari	ēnzāri, īnzari
en+zari-na	ēnzarra, īnzarra
en+zari-ra	inzarra
en-a=d, eni-a=d	enad
eni	ene, eni
eni-na	ēnna
eni-na-āš-ta	ēnnāšta
eni-āe	enāe
eni-ž	enež
eni=ma	enima
enni-da, enni-i-da	ennida
ennigaldi	enigaldi, ēnnigaldi
ennigaldi-āe	iningaldāe
enummē	enummē
er+āna, er+āni-a	erāna
er+āna=lla, er+āni-a=lla	erānalla
er-ō-l-eva	erōliva
erade	erade, erādi
erade-n, erade=n, ir-ad-i-en	iraden
erade-ne-ž	eradiniž
erade-ož	iraduž
erade-āe	eradāe
erižangi-āe	erižangāe
ervi	ērbi
ervi-na-āž-a	irbīnāža
ervi-ne-ž	irveniž, ērbinež
erġi=ma, ērġ-i=ma	ērġima
ev+ar+že	evarži
evari-f-fa=an, evari-f-fa=n, evari-iffe-a=an, evari-iffe-a=n	evarip⸢fa?⸣an
ever+ni	ebirni, everne
ever+ni-a	ebirna, ibirna
ever+ni-na	ēbrinna
ever+ni-na-až-a	ēbrinnaža
ever+ni-na-až-ož	ibrinnažuž
ever+ni-na-āž-ō-nna	ēbrināžōnna
ever+ni-ne-va	ēbrinniba
ever+ni-ne-ž	ēbrinniž
evr+in+že	ēbrešši
evr+in+že-p-pe-ne-ne=m	everinžippininim
evren+ze-a	ibrinza
evri	ebri, ibri, ēbri
evri-i-da	ebrida, ēbrida
evri-i-va	ēbriva
evri-i-vē, evri-vē	ēbrivē
evri-i-ž, evri-ž	ēbrež
evri-ē-da	ēbrēda
evri-ī-da	ēbrīda
evri-ž	ebrež, ibrež, ēbriž
eġ+epš-ulli=ma	eġepšullima
eġ+epš-ullī=ma	eġepšullīma, šullīma
eġari	eġari
eġari-ne-ve-ne-da=l	eġarribinidal
eġi-ne-n	eġinen
eġl+i+ġe	eġliġi
eġl-i-l-eva-š=nna	eġilli⸢fa⸣ašša
eġli+ana-ž	eġlianaž, ēġlianaž
eġli-ve	eġlibi
eġli-ve-na	eġlibina
eġli-ve-ne-da	eġlibinida
eġli-ve-ne-ve-na	eġlibinibina
eġli-ve-ne-ve-na-āž-a	eġlibinibināža
ešk+ar+i-ne, ešk+ar+i-ne-e	eškarri
eškāve	eškāve
eššae-ne, eššae-ne-e	eššaeni
eže	eže
eže-a	eža
eže-na	ežena
eže-ne, eže-ne-e	ežene, eženi
eže-ne-va	eženiva
eže-ne-ve	eženibi, eženive
eže-ne-š=nna	eženišša
eže-nē-ve	eženēbi
ežeb.ābu-š=nna	ežebābušša
ežeb.ābu=n, ežeb.ābu=n	eževabun
ežeži-a=l	ežežal
fa-i-kki=mān	faikkimān
fad-eġ-i-b, fadeġi-b	fadeġib
fael-i, faeli	faeli
fal-o-kko	falukku
fand+a+ni	fandani, pandani
fand+ar+i+nni-a	pandarinna
fand+ar+i+nni-nā=ma	fandarinināma
fand-ar-i, pand+ar+i	pandari
fandi+n	fandin
fandi-b	pāndib
fandi-i-až-a=l, pandi-i-až-a=l	pandiažal
faz+ur+a+nni	fa⸣suranni
faġ-ōž-a	fāġōža
faġr+a+že	faġraži
faġr+o+vāde	faġruwāde, paġrubādi
faġr+o+vāde-a	fāġruwāda
faġr+o+že	faġruži, paġruže, paġruži, pāġrōži
faġr+o+že-a	faġruža, pāġrōža
faġr+o+že-na	paġrōžina
faġr+o+že-ne-e	pāġružini
faġr+o+že-ne-ž	pāġrōžinež
faġr-i, faġri	fāġri
faġr-o-ež, faġri-ož	paġruž
faġri-a	fāġra, paġra
faġri-ā=ma	faġrāma
fašt-o, fašt-u	faštu
fašš+ar+i-a, fašš-ar-a, fašš-ar-a	faššara
fašš-i, fašši	fašši
faž+ūli=ma, faž-ūl-i=ma	fažūlima
faž-a-b	fažab
faž-a=mma, fāži-a=mma	fažamma
faž-i-a, fāži-i-a, pāži-i-a	pāžia
faž-i=l	fāžel
faž-id-o	pāžidu
faž-o-ež, fāži-ož	fāžuž
faž-u	fāžu
faž-u+m+ai	fažumai
faž-ēd-a	fažēda, pažēda
felz-a-b	felzab
fendi-a, pend-a	fenda
fir+iški	firiški
fitf-a, fitfi-a	fitfa
fižaišfi-ne=l	fižaišfinel
fod+i+ġe	fodiġi
fog+ugar+i	fogugari
fog+ādi-a, fog-ād-a	fogāda
fog-uġ-ō-m	fouguġūm
fogl-b-a, pugulbi-a	pugulba
fogl-āl-a	foglāla, puglāla
fondur+o+ni-ne-e=nna, fondur+o+ni-ne-nna, fondur+o+ni-ne=nna, fondur+o+nni-nna, fondur+o+nni=nna	fondurunnenna
fonuġ+o+ni-na, fonuġ+o+nni-a	fonuġunna
for+ali-ī-ne-ē, for+ali-ī-nē, for+all+ī+nnē, fōr+all+i+nni-i-ē, fōr+all+i+nni-iē	fōrālīnie
for+āna, for+āna-a	forāna
for-ed-i	foride
for-i	pōri
for-i, for-i, fōri	fōri
for-i-le	forili
for-i-va-en-i=ma	forivaenima
for-i=l, fōri-i=l	fōril
for-i=ma, fōri=ma	forima
for-ošt-ugar-iž-a	pōruštugariža
for-ud-o-m	pūrudum
for-ušš-o-en-i=m, foruššue+nni=m, foruššueni-ne-e=m, foruššueni-ne=m	foruššuenim, foružuenim
for-ušš-o-ēn-i=m, foruššue+nni=m, foruššueni-ne-e=m, foruššueni-ne=m	foruššuēnnim
for-ēd-i	forēdi
for-ī=m=an, for-ī=man, fōri-ī=man	fōrīman
fovi-āi	fovāi
fud+ar+i+nni-a=lla	fudarinalla
fud+ol+i+m+a+šše	pudulimašši, pudulimāšši
fud+ol+i+m+a+šše-na-až-a	pudūlimaššinaža
fud+ol+i+m+a+šše-na=ma	pudūlimaššinama
fud+ol+i+ni-āi, fud-ul-in-i-āi	pudulināi
fud+ō+re	pudūri, pūduri
fud+ō+re-i-ž, fud+ō+re-ž	pudūrež
fud+ō+že-a, fud-ōž-a	fudōža
fud-o, fud-o, fud-u	pūdu
fud-o, fud-u	fōdu
fud-o-ež	puduž
fud-ošt-a-b-ā=l	pōduštabāl
fud-ōšt-o, fud-ōšt-u	fudōštu
fut+ki	putki, pūtki
fut+ki-b	futkib
fut+ki-da	putkīda
fut+ki-i-ž, fut+ki-ž	futkiž
fut+ki-na	futkina, putkina
fār-a, fāri-a	fāra
fār-i-e, fāri-i-e, fāri-ie, fārē	fārie
fāzanigar-ve-až	fāzanigarvaž
fāġadi	fāġadi
fāžani-ae	pāžanae
fāžani-na	fāžanna
fāžani-ne, fāžani-ne-e	fāžanni
fāžani-ne-e=l, fāžani-ne-ž=l, fāžani-ne=l, pāž+a+nni-i=l, pāž+a+nni-ž=l	pāžannel
fāžani-āe	pāžanāe
fāži	fāže, fāži, paži
fāži, fāži-i, pāži	pāži
fāži-b	pāžib
fāži-da, fāži-i-da	pāžida
fāži-i-va, fāži-va, pāži-i-va, pāži-va	pāžiba
fāži-ī-va, fāži-ī-va	fāžīva
fē-lla, fē-ž=l	fel
fē-uda	fiwta
fē-va	feva
fē-ve	pēbi
fē-š=nna	pēšša
fē-ž	pēž
fē-ž-a	fēža, pēža
fē-ž-uda	fēžuda
fē-ž-ūda	fēžūda
fēl-o-ež	fēluž
fēll-ož-a	fēlluža
fēn+ā+ni-a, fēn-ān-a	fēnāna
fēḫḫ-ēd-a, fēḫḫi-ie-da	fēḫḫēda
fōnuġōn+že	fūnuġōnži
fōr+all+i+n+ze, fōr+all+i+n+ze-i-ē, fōr+all+i+n+ze-iē	fōrālīzie
fōr+all+i+nni-na-až-a=l	purallinninažal
fōri-da, fōri-i-da	fōrida, pōrida
fōri-f-fa=ān, fōri-f-fā=n, fōri-iffe-a=ān, fōri-iffe-ā=n	fōriffān
fōri-i-va, fōri-va	pōriba
fōri-ī-da	fōrīda
fōrol+žari-na-až-a=an	fōrulžarražan
fōroli-na-až-ož=l	fōrullažul
fōroli-ne, fōroli-ne-e	fōrulli, pōrulli
fōroli-ne-n	pōrullin
fōroli-ne-ve	purullibi
fōroli-ne-ve-na	fōrullibina, pōrullibina
fōrunz+i+ġe	fōrunziġi
fūr-u	fūru, pūru
ibi	ibi
ibi-ai	ibāi
ibi-i=ma, ibi=ma	ibima
ibi-ne, ibi-ne-e	ibini
ibi=m	ibim
ibr+ad+n+a+ni-na, ibr+ad+n+a+nni-a, ibr+ad+ni-a=nna	ibradnanna
id+ni	idni, ēdni
id+ni-a	idna
id+ni-b	idnib
id+ni-da, id+ni-i-da	idnida
id-ar-i-l-āi	idarrāi
id-ed-i	idedi
id-i, id-i, ide	idi
id-i-a, ide-i-a	idia
id-i-l-ānni	idilānni
id-ī-e	idīe
ide	ide
ide-b	ideb, idib, idīb
ide-b-ož, ide-ve-ož	idebuž
ide-b-uda	idibuda
ide-b-ōda	idibōda
ide-da, ide-i-da	ideda, idida
ide-i-až	idiaž
ide-i-až-a	ediaža, idiaža
ide-i-da	edida
ide-i-va, ide-va	ideba, idiba
ide-i-ve, ide-ve	idibi
ide-iffū-da	ideppūda
ide-p-pa	ideppa
ide-ī-da	idīda
ide-ž-ūda	edežūda
idenna-ne-ž	idennanež, idennaniž
idenni	idenni
ieni-p-pe-n(e)-e=d	īnippinid
igi-na	igina
igingališ-va	igingalīšša
igingališ-ḫe-nā=ma	igingališḫenāma, igingališḫināma
igingališ-ḫī-na=mma	igingališḫīnamma
ikk+amm+a+šše	ikkammašši
il-a, ili-a	ila
il-ešk-a, ileški-a	ileška
ilamd+ō+ġe	ilamdōġi
illaia-ġe	illaiaġe
ilāvā-a=ān, ilāvā-ā=n, ilāvā=n, ilāvā=ān	ilāvān
ilōllani-na	ilōllanna
immande-na	immandena
immarde-a	immarda
immari-ne-da	immarrida
immarvaġe-na-āž-e	immarvaġināže
immašku=n	immaškun
in+i+tḫ+ar+i-na	initḫarra
in-ūr-o, in-ūr-u	inūru
ind+a+ni-ne-e=m, ind+a+ni-ne=m, ind+a+nni=m, ind-i-anni=m	indannim
ini-ve-āi	inibāi
inu	inu
inu=ma	inuma
inu=mma	inumma
inu=mē	inumē
inu=tta	inutta
inġ+ar+i-a	inġara
inġ-a=d, inġi-a=d	inġad
ird-i, irde, irde-i	irdi
irde	irde
irde-b	irdib, īrdib
irde-da, irde-i-da	irdeda, irdida
irde-ī-ž	irdīž
irdōv+ā+nni-ne-ve	irdōvānninibi
irial+zi	irialzi
irn-a	irna
irġāri	irġāri
iss-ēd-i	issēdi
itk+o+re-ne-e=lla, itk+o+re-ne-ž=lla, itk+o+re-ne=lla	itkurinella
itk+ud+ut+ki	itkudutki
itk+ul+i+m+a+šše	itkulimašši, itkulimāšši, itkulumašši
itk+und+o+re	itkundōri
itk-a	itka
itk-ašt-a	itkašta
itk-ašt-a-b	itkaštab
itk-ašt-i-b	itkaštib
itk-i-a-ž	itkiaž
itk-i-a=an, itk-i-a=n, itk-i-an	itkian
itk-i-ai-š=nna	itkaišša
itk-i-anni=m	itkannim
itk-id-anni=m	itkidannim
itk-id-o	itkidu
itk-ind-o-ež	itkinduž
itk-o-ež	itkuž
itk-o-ež-a=lla	itkužalla
itk-o-l-āe-ž	itkulāež
itk-o-l-ēž	itkulēž
itk-ol-a	itkula
itk-ol-d-a	itkulda
itk-ol-u-nd-a-šše	itkulundašši
itk-ol-āw-ž	itkulāuž
itk-ož-ill-and-i-n, itk-ož-ill-and-i=n	itkužellandin
itk-u-nd-a-šše-na=ma	itkundaššinama
itk-u-nd-a-šše-na=mma	itkundaššinamma
itk-ud-ol-ed-a-šše	ētkudulidašši
itk-umme	itkummi
itk-ušt-o-m, itk-ušt-o=m	itkuštum
itk-ā=l	itkāl
itk-ō-ež	itkōž
itk-ō-l-āi, itk-ōl-i-āi	itkōlāi
itk-ōl-a, itk-ōl-a	itkōla
itk-ōl-i	itkōli
itk-ōž-a	itkōža
itkal+zi	itkalzi
itkal+zi-a	itkalza, itkalzia
itkal+zi-ai	itkalzai
itkal+zi-ne-ve	itkalzinibi
itkal+zi-ne-ve-na	itkalzinibina
itkal+zi-ne-ve-na-až-ož	itkalzinibinažuž
itkal+zi-ne-ve-na-āž-ož	itkalzinibināžuž
itkal+zi-ne-ve-na-āž-ož=mma=an	itkalzinivināžummin
itkal+zi-ne-ve-ne-ž	itkalzinibinež
itkal+zi-ve-na-až-a=dil	itkalzibinažadel
itkal+zi-ve-na-āž-a	itkalzibināža
itkal+zi-ve-āi	itkalzibāi
itkal+zi-āe	itkalzāe
itkal+zi-āi	itkalzāi
itkan+zi-a=lla, itkan+zi=lla	itkanzalla
itt-a	itta
itt-i-l-āe, itt-i-l-āe	ittilāe
itt-i-le, itt-i-le	ittili
itt-ō-va-en, itt-ō-va-en, ittūbi-n, ittūbi=n	ittūbin
itḫi-ne-ž	itḫiniž
iv-i, ivi	ivi
iv-ā, ivi-ā	ivā
izuzi	izōzi, izūzi
izuzi-a	izūza
izuzi-i-va, izuzi-va	izuziva
iġ-ō-vōr	iġōffōr
iġari-ne-n	iġārrin
iġari-ā	iġarā
išk-a, iški-a	iška
išk-i=nna, iški+ni-na, iški-i-nna, iški-nna, iški=nna	iškinna
išk-id-o	iškidu
iški+ni-i-až	iškiniaž
išt-i, ište	išti
išt-i-en=nna=ān, ište=nna=ān	īštennān
išt-o-m=ma, išt-o=ma, išt-u=ma, išt-umme-a, ištumi-a	ištuma
ištani	ištaniž
ištani, ištani	ištani
ištani, ištani, ištani	ištāni
ištani-i-da	ištanida, īštanida
ištani-n, ištani=n	ištanin
ištani-ī-da	ištanīda
ištani-ī=ma, ištani=ma	ištanīma
ištani-īffe-ā=l	ištānīffāl
ište	ište
ište=n	išten
ište=nna=nan, išteni-na=nan, ištenni-a=n=an	ištennanan
išteni	išteni, išteniž
išteni-f-fe=mma, išteni-f-fā=mma, išteni-iffe-ā=mma, išteni-iffe=mma	išteniffāmma
išḫara	išḫara
išḫara=an, išḫara=n	išḫaran, išḫāran
išḫoni-va	išḫuniba, išḫōniba
iž+ar+i-ne-va	ižarriva
iž+ikk+o+nni-a	ižikkunna
iž-a, iža, iža-a, iži-a	iža
iž-až	ižaž
iž-i, iž-i, iži	iži
iž-o-eš=til, iž-ušt-i=l	ižuštel
iž-ī+m+āi-n, iž-ī+m+āi=n	ižīmāin
iž-ī=ma, iž-ī=ma, iži-ī=ma, iži=ma	ižīma
iža+mme	ižammi
iža+mme-ne, iža+mme-ne-e	ižammēni
iža-ve-na, iža-ve-ne-a	ižāvena
iža-vē=ma	ežābēma
iže-na	ižena
iži-ne-ve-āi=n	ižinibāin
iži-ne-ž, iži-ne-ž	ižinež
iži-ve-āi	ižibāi
iži-ve-āi=n	ižibāin
ižuġ+ni	ežuġni, ižuġni
ižuġ+ni-a	ižuġna
ižuġ+ni-ai	ižuġnai
ižuġ+ni-ž	ežuġnež
ka+i+ġe-da, ka+i+ġe-i-da	kaiġida
kabl-i-āi, kabli-āi	kablāi
kabli-ne-ž	kaballiž, kāballež
kad-al-a, kād+ali-a	kādala
kad-ašt-i	kādāšti
kad-i, kadi	kadi, kādi
kad-i-a	kadia, kādia
kad-i-b, kad-i=v, kadi-b	kadib
kad-i-l-ēž	kadilēž
kad-i-o	kadīw
kad-i-ō-šše-na	kadiōššina
kad-i=mma	kadimma
kad-id-a	katta
kad-il-i-le	kadilli
kad-ind-o-ež	kadenduž
kad-o-kko	kādukku
kad-ol-i-en	kadulen
kad-ol-i-le	kadulli
kad-ān-o, kad-ān-u	kadānu
kad-ō-l-āī-n, kad-ō-l-āī=n, kad-ōl-i-āī-n, kad-ōl-i-āī=n	kādūlāīn
kad-ūv-a	kādōva
kadi, kāde	kāde
kakkari	kakkari
kakkari-a	kakkara
kakkari-ia-ne	kakkariani
kal-ō-vade	kalōvadi
kal-ūw-a	kalūwa
kalb-uġ-ēd-a	kalbuġēda
kalgamiž-ož=l	kalgamižul
kamali-ne-nna	kamallenna
kamm+a+ḫḫe-ne-ž	kammaḫḫinež
kamm+an+ġe-ia-ne	kammanġiani
kamme	kāmmi
kamme-ne-ž	kamēnež
kammiššōri	kammiššōri
kamv-i-d-a, kamve-da	kamveda
kan+āg-i-ež	kanāgiž
kan+āg-iž-a	kanāgiža
kanagitḫe	kanagitḫi
kangalvi-a=lla	kangalvalla
kangalvi-ā=lla	kangalbālla
kanz-o-kko=m	kanzukkam
kapp-i-l-eva-ž	kappilivaž
kapš+o+ġe-ā=l, kapš-uġ-ā=l	kapšuġāl
kapš+o+ġe-ā=ma, kapš-uġ-ā=ma	kapšuġāma
kapš-a, kapši-a	kapša
kapšalla	kapšalla
kapši-ne-nna	kapšinina
kar+apt-ed-a, karapte-da	karapteda
kar-i, kāri	kāri
kare-na-āž-ož	karēnažuž
kare-ne-ž	karinež
karg+ā+ni, karg-ān-i	kargāni
kariži-ī-da	karižīda
karži, karži-i	karži
karži-b	karžib, kāržib
karži-da, karži-i-da	karžida
kat+ki	katki
kat+ki-na-až-ož	katkinažuž
kat+ki-na-āž-ož	katkināžuž
kat+ki-ne	katkini
kat+ki-āi	katkāi
kaġ+a+ni-da=ma, kaġ+a+ni-i-da=ma	kaganidama
kaš-t-i, kašt-i, kašti	kašti
kaška=an, kaška=n	kaškan
kažiari	kažiari
kažiari-ne-ne=l	kažiarrinel
kažidabi=ma	kažidabima
kažl-a, kažli-a	kažla, kāžla
kažl-o-ež	kažluž
kažl-o-l-ai-ž	kažlulaiž
kažl-o-l-aē-ž	kažlulaēž
kažl-o-l-āe-ž	kažlulāež
kažl-o-l-ēž	kažlulēž
kažl-ol-a=m	kažlulam
kažl-ož-ill-and-i-n, kažl-ož-ill-and-i=n	kažlužellandin
kažl-uw-a	kažluwa
kažl-ōž-a	kažlōža
kažli-na, kāž-a=lla, kāži-a=lla	kažalla
ke-i-eva, kev-a, kēbi-a	kēba
ke-ī-le, kil-i, kili	kīli
keb+li	kibli, kēbli
keb+li-na-āž-ož	kēbillāžuž
kel+di, kēl-d-i	kelde
kel+di-ia-ne	keldiani
kel+di-ne-ve-āe	keldinibāe
kel+di-āi	keldāi, kēldāi
keli+gel-ešt-o-m	kiligileštum
keni-na, kenni-a	kenna
ker+a+šše	kirašši, kēraži
ker+ā+že	kirāži, kērāži
ker+ā+že=ma	kiražima, kirāžima
ker-āž-o-ež	kērāžuž
kerētte	kirētte
kev+o+že-ož, kev+o-že-ož, kev-ož-o-ež, kiv-ož-o-ež	kivožuž
kev-a, kevi-a	kēva
kev-a-šše, kib+a+šše	kibašši
kev-e, kippe	kibe
kev-i-b-ā=d, kev-i-eva=d	kibibād
kev-o-l-aē-š=nna	kibulaēšša
kev-o-l-āe-š=nna	kēbulāešša
kev-o-re	kivori
kev-ud-u	kivudu
kev-uffu	kibuppu
kev-ā-šše, kib+a+šše	kibāšši
kev-ō-l-ež	kibōliž
kevri-na	kiverra, kēverra
kevri-na-āš-ta	kivērāšta
kevri-na-āž-a=n	kivirāžan
kevri-nā=m	kēvirrām
keški	kēški
kešše	kešše, kišši
kešše-ne-da=l	keššenidal
kešše-ne-va	keššeniva
kešše-ne-š=nna	keššenišša
kešše-nē-ž=l	keššenīel
kešše=ffa=an	keššippan
kešše=n	kiššen
kešḫ-i	kišḫi
kešḫ-id-en	kišḫiden
kešḫ-iž-a	kišḫiža
kešḫi	kešḫi, kēšḫe
kešḫi-da, kešḫi-i-da	kišḫida
kešḫi-dan, kešḫi-i-dan	kešḫidan
kešḫi-i-až-a=l	kišḫiažal
kešḫi-n	kišḫin
kešḫi-na-āž-e	kešḫenāži
kešḫi-ne, kešḫi-ne-e	kišḫini
kešḫi-ne-e	kešḫini, kišḫeni
kešḫi-ne-n	kišḫinin
kešḫi-ī-da	kešḫīda
kiaže	kiaži, kīaži
kiaže-ne, kiaže-ne-e	kiāžēni
kiaže-ne-da=an, kiaže-ne-da=n	kiaženidan
kiaže=ma	kēažima
kib+a+šše, kib-a-šše	kībašši
kib+o+re, kiburi-ne, kiburi-ne-e	kibure
kibi	kibi
kibridi-a=dil, kibridi=dil	kibridadel
kig-ad-uw-a=mma	kigaduwamma
kiglibadalli=n	kiglibadallin
kikk+o+ni=ma	kikkunima
kikk+o+ni=mma	kikkunimma
kikk-uġ-ēd-a	kikkuġēda
kil+ān-a-b	kilānab
kil+ān-i-ež	kilānež
kil+ōn-i	kilūni
kin-i-āe, kini-āe	kināe
kinn+ār+i, kinn-ār-i	kinnāri
kip-t-an-ed-a, kipt-an-ed-a	kiptaneda
kippe-na	kippēna
kippi-ne-ž	kippinež, kippiniž, kīppinež
kir+ar+i+nni, kir+ari+ni-ne, kir+ari+ni-ne-e	kirarinni
kir+ar+i+nni-a	kirarinna
kir+ar+i+nni-i=l=am	kirarinnilam
kir+ari+ni	kirarni
kir+ari+ni-i-ž, kir+ari+ni-ž	kirarnež
kir+ašš-o-l-aē-ž	kiraššulaēž
kir+man-a	kirmana
kir+mān+ze-ne-e	kirmānzeni
kir-ar-ašt-o-m	kiraraštum
kir-o-l-ēž	kirulēž
kir-o=nna	kirunna
kir-uġ-ed-a	kīruġida
kire+n+ze	kirenze, kirenzi, kirinzi, kērenze
kire+n+ze-a=mma	kīrenzamma
kire-ne-da	kirinida
kiri-āe	kirāe
kirġe	kirġe
kirġe-ve	kirġivi
kiv+ōr+ġē-ne-v-ōž, kiv+ōr+ġē-ne-v-ōž	kivōrġēnivōž
kiġe-ne-ž, kiʾe-ne-ž, kiḫḫe-ne-ž	kiġenež
kiš+kiž+i+a+šše+ni-na, kiš+kiž+i+a+šše-ne-nna	kiškižiaššenina
kiž+ar+že-ne-ž	kižarženež
kižipsōvae	kižipsōvāe
kol-a, kul-a, kul-a, kuli-a	kula
kol-i-ež	kōlež
kol-i-l-āe, kul-i-l-āe	kullāe
kub-aġ-i-āe, kubaġi-āe	kubaġāe
kubaba-ve-āi	kubababāi
kubāġi-ne-e=l, kubāġi-ne-ž=l, kubāġi-ne=l	kubāġinel
kud-i-aī-ž	kūdaīž
kud-id-e	kutte
kud-o	kūdu
kud-o-kko	kudukku
kuduni-b	kudunib
kul+am+ud+ut+ki	kulamudutki
kul+am+ud+ut+ki-āi	kulamudutkāi
kul+am+ō+rre-ne-ve	kulamōrrinibi
kul+i+m+ā+šše-na-āž-a	kulimāššināža
kul+i+mm+ā+šš+ō+ḫḫe-a	kulimmāššōḫḫa
kul+i+ġe-ia-ne	kuliġiani
kul+u+mb-i, kulumbi, kulumbi-i	kulumbi
kul-am-ow, kul-am-u-ow, kul-am-ū	kulamū
kul-d-i=m	kuldim
kul-d-o=m, kul-d-u=m	kuldum
kul-i-a-mma	kūliamma
kul-ož-a-šše, mal-ož-a-šše	kulužašši
kul-ōr-o-m	kulōrum
kul-ūr-o-m	kulūrum
kulamur+ni-i=lla	kulamurnella
kuldubi-n	kuldubin
kuli-na	kūlīna
kulm+o+re	kulmuri, kulmōri
kulm+o+re-na	kulmurina
kulm+o+re-ne, kulm+o+re-ne-e	kulmurri
kulm-o, kulm-u	kulmu
kulm-upp-a	kulmuppa
kulmōri-ne-n	kulmōrrin
kulve-nā=ma	kulvenāma
kulzi-i-ž, kulzi-ž	kulziž
kulzi-ne-ž	kulzinež
kumarve	kumarbi, kumarve
kumarve-ne-ve	kumarbinive
kumarve-ne-ž	kumarvenež
kumarve-ne-ž=l	kumarvenel
kumarve-ne-ž=lla	kumarvenella
kumarve-nē-ž	kumarbinī
kumarve-nē-ž=l	kumarvinīel
kumarve-ž	kumarbiž
kumm+ō+ġe	kummōġi
kumme-ne-e	kummini
kumme-ne-ve	kummenive, kumminibi, kumminive, kumminivi
kumme-ne-ve-ož	kumminivož
kumme=n=i=m	kumminim
kumr+o+ḫḫe-ā=l	kumruḫḫāl
kumri	kumri
kumri-i-ē, kumri-iē, kumrē	kumrie
kund-i, kunde	kundi
kundari	kundari
kundari-ne-n	kundarrin
kundāri	kundāri
kundāri-ne-n	kundārrin
kune-ne-e=n, kune-ne-n, kune-ne=n	kūninin
kune-ne-va	kuniniba
kune-ne-ve	kuninibi
kungallē	kungallē
kunz-i+m+ai	kunzimai
kur+a+nni-i-a, kur-ann-i-a	kurannia
kur+a+ḫḫe-a, kur+aḫḫ+i-a	kuraḫḫa
kur+aḫḫ+i	kuraḫḫi
kur-upp-a, kur-upp-a, kuruppi-a	kuruppa
kurgōrvi-i-aš=nna	kurgōrveašša
kut+kūd-a, kut+kūdi-a, kutk-ūd-a	kutkūda
kutte-ae	kuttae
kutte-ne, kutte-ne-e	kutteni
kuttive+ni-na, kuttive-na, kuttive-nna	kuttivenna
kuz+o+ġe, kuz-uġ-i	kuzuġi
kuž+u+šk+o+že-ne-ve, kuž+u+šk+o+že-ne-ē, kuž+u+šk+o+že-nē	kužuškuženie
kužaġ	kūžaġ
kužaġ-fe	kužapḫi
kužuġ	kūžuġ
kābari-na	kābarra
kāl-a, kāli-a	kāla
kāli-ia-ne	kaliani
kāli-ne-ž	kāllež
kāni	kāni
kāv-ā=lla, kāvi-ā=l	kāvāl
kāze	kāssi, kāzi
kāze-ne-vā=d	kažinibād
kāze-ož	kāzuž, kāžuž
kāze-ōž	kāzōž
kāššui	kāššui
kāž-a, kāži-a	kāža
kāž-o-kko	kāžukku
kēbi-na	kēbina
kēbi-ne, kēbi-ne-e	kēbini
kēd+ad+o+že-i	kēdadužei
kēd-a, kēdi-a	kēda
kēl-ad-i	kēladi
kēl-o=m	kilum, kēlum
kēl-ol-a	kēlula
kēl-uff-a	kiluffa
kēl-ād-i	kēlādi
kēl-ōl-a	kēlōla
kēl-ōl-o	kilōlu
kēlġēdi-ne, kēlġēdi-ne-e	kēlġēdeni
kēnn+ār+i-a=l, kēnn-ād-a=l, kēnn-ār-a=l, kēnnādi-a=l	kēnnādal
kēr-i-o-šše-ne-nna	kēriuššininna
kēri-ie-ne, kērē-ne, kērē-ne-e	kērēni
kīdāvi-a	kīdāba
kīdāvi-ae	kīdāvae
kīge	kīgi, kīgie
kīge-i-āž-a	kīgiāža
kīzir+že-ne, kīzir+že-ne-e	kīzirženi
kīziri-ne-va	kīzirriva, kīzīrriva
kīšk+ūpp+ē-ne-da	kīškūppēnida
kōlm-a, kōlmi-a	kōlma
kōm-ur-a, kōmuri-a	kōmura
kōpp+a+nni-a=l	kōppannal
kōr-upp-i, kōruppi	kōruppi
kūdade-na	kūdadena
kūg-o-kko	kūgukku
kūm+de	kumdi
kūm+de-ne-ve-ne-e=n, kūm+de-ne-ve-ne-n	kūmdenivenin
kūmuri-ne-da	kūmurrida
labla+ḫḫe-ne, labla+ḫḫe-ne-e	lablaḫḫini
labla+ḫḫe-ne-da	lablaḫḫinida
labla+ḫḫe-ne-ž	lablaḫḫinež
lallari-ne-ž	lallarrež
laġlaḫḫi-ne, laġlaḫḫi-ne-e	laġlaḫḫini
laġlaḫḫi-ne-da	laġlaḫḫinida
leli	lēli
lull+i+mb+ar+i-a	lullimbara
lullue-ne-ve	lullueneve
mad-l-a, madl-a, madli-a	madla
magaldi-ne-va	magaldiniba
magaldi-ne-ve	magaldenibi
magaldi-ne-ve-na-āž-a	magaldinibināža
magaldi-ne-vā=d	magaldinibād
mal-a, mali-a	mala
mal-i-āe, mali-āe	malāe
mali, māl-i	māli
mall+ade-ae=l	malladael
malvāži	malvāži
mamm+o+re-ne-e	māmmurinie
man-a, mān+a	mana, māna
man-a=l, mān+a=l	mānal
man-uda	mānuda
man-z-a	manza
man-z-ōra	manzōra
man-z-ōž, manu-ž-ōž	manzōž
man-ōž=l	mānōl
mandukki-ae=lla	mandukkaella
mandukki=mma	mandukkimma
mannamištu=n	mannamištun
manu-ra, mān+o+re-a	mānura
manu-wa=lla	mānuballa
manu-ž	mānuž
manu-ž-ōrā=ma	manzōrāma
mar+i+šḫe	marešḫi
mar-ašt-i, marašte	marašte
mar-i, mari	māri
mar-ož-i, maroži	maruži
mar-ud-a, marudi-a	maruda
mardam+a+ni-ne, mardam+a+ni-ne-e, mardam+a+nni, mardamanni	mardamanni
marne-ne-e=l, marne-ne=l	marninel
mazanuri	mazanuri
maētta+ni-a	maēttana
maġ-ār-a	maġāra
maġiri-ne-e	maġirri, māġirri
maġitti	maġitti
maġōri-ne, maġōri-ne-e	maġōrri
maž-ag-o-m	mažagum
mel+aḫḫ-o-m	melaḫḫum
meġ-a	meġa, mēġa
meġ-ō-m, miġ-ō-m	miġōm
mig-ummi	migummi
mil-ol-ad-i-l-āe	miluladilāe
mil-ol-ād-o, mil-ol-ād-u	milulādu
mini	mini
mir+e+šḫi-ne, mir+e+šḫi-ne-e	mirešḫini
mir+ul+avi-ā=l	mirulavāl
mirž-i-āe, mirži-āe	miržāe
mirž-ā=l, mirži-ā=l, mirži=l	miržāl
mor-i-l-āe, murri-āe	murrāe
mun-o-ež, muni-ož	munuž
mun-uġ-ož-i-l-āi	munuġuželāi
munġ-ī-e, munġi-ī-e, munġi-īe	munġīe
murri-ī-e	murrīe
murġ-ol-išt-a, murġulišti-a	murġulišta
muž+u+ni	mužūni
muž+u+ni-na	mužunna
mužoni-ne-va	mužunniba
mužoni-va	mužuniba
mužoni-ž	mužuniž, mužunniž
mužunni	mužunni
mā=n, mā=ān	mān
mād-ašt-a-b	mādaštab
mād-i, mādi	mādi
mād-il-i-le=lla, mādili-ne-e=lla, mādili-ne-ž=lla, mādili-ne=lla, mādilli-i=lla	mādillilla
mād-t-a	mātta
mād-t-a=l	māttal
mād-uw-a	māduwa
mād-ōl-i	madōli
mādi-a=ffa	madaffa, madappa, mādaffa, mādappa
mādi-ai	mādai
mādi-da, mādi-i-da	mādida
mādi-i-e, mādi-ie	mādie
mādi-na	mādena
mādi-na-až-a	mādinaža
mādi-ne-ve	mādinibi, mādinivi
mādi-ā=ffa	madāppa
māl+ō+žē-na	mālōžēna
mām+o+re-ne-ve	māmurinibi
mān+g+a	mānga
māni-ne-n, mānn-e=n, mānne=n	mānnin
mānn-o-bōr	mānnubōr
mānn-ō-bor	mānnōbur
mānne	mānie, mānni
mānnuwali-ne, mānnuwali-ne-e, mānnuwalli	mānnuwalli
māġri	māġri
māški	māški
mēg-umme	mēgummi
mēgi	mēgi
mēgi-ne-ž	mēginež
mēgi-ne-ž=lla	mēginella
mēgi-nē-ž	mēginie
mēr-i-ež, mēri-i-ž, mēri-ž	mērež
mīr-i-l-ēž, mīri-nē-ž	mīrrīž
mōri-ne, mōri-ne-e, mōrri	mōrri
mōrri-na	murrina, mōrrina
mōrri-ne-va	murriniba
mōrri-ne-vā=dil	mōrrinibādel
mū+i+re	muwiri
mūgižanun	mūgižanun
mūnurimi-ne-da	mūnuriminida
mūž-i-b	mūžib
mūž-ēd-ā	mūžēdā
mūž-ōl-ō-m	mužōlōm
na+i+ġē-na, na+i+ġē-ne-a	naiġēna
nab+ar+i-ne-va	nabarriba
nabarbi	nabarbi
nabarbi-ne-da	nabarbinida
nabarbi-ne-ve	nabarbinibi
nabarbi-ne-ve, nabarbi-ne-ē, nabarbi-nē	nabarbinie
nabarbi-nē-da	nabarbinēda
nabarbi-ve-na-āž-ož	nabarvināžuž
nabarbi-ž	nabarbiž
nabarbi=n	nabarbin
nabari-ve-na-až-ož	nabarbinažuž
nabni-da, nabni-i-da	nabnida
nabni-ī-da	nabnīda
nagēri	nagēri
nai-na-až-ož	nāinažuž
nai-na-āž-ož	nāināžuž
nai-īa-nē, naīa-ne-ve, naīa-ne-ē, naīa-nē	naīanie
nak-t-i, nakt-i, nakti, nakti	nakti
nakk+a+šḫe-a	nakkašḫa
nakk+a+šḫe-a=m	nakkašḫam
nakk-ed-aššo	nakkidaššu
nakk-ed-aššō	nakkidaššō
nakk-ed-āw-ž	nakkidāōž
nakk-ed-ūw-a	nakkidūwa
nakk-i	nakki
nakk-i-uffo-š=nna	nakkiwfošša
nakk-i-ōffu-ž	nakkiōffuž
nakk-i-ōššo=nnā	nakkiōššunā
nakk-i=ma	nakkima
nakk-uffu	nakkuppu
nakti-b	naktib
namli-a	namla
namli-na-āž-a	nammallāža, nāmallāža
namni-va	namniva
natk+āmm+a+ni-na-āž-a	natkāmmannāža
natki-ne-n	natkinin
natḫi-a	nātḫa
natḫi-ne-n	natḫinen
nau+ni-na-až-a	naunnaža
nau+ni-ne-ve	naunnibi
nau+ni-ne-ve-na, nāū+nni-ve-na	nāwunnebina
nau+ni-ne-ž	nawunnež
nau+ni-ī-e, nau+ni-īffu-we	nawnībuwe
nav-a	nāva
nav-an-ed-a, nav-an-ed-a, navani-da	navanida
nav-e, nav-e, nave	nave
nav-ed-a, nave-da	naveda
navari	navari
nave	nābi
nave-i=ma, nave=ma	nābima
nave-ne-ž	navenež
naġmazuli-ž=l	naġmazulel
naīa-na-āž-a	naēnāža
našp-a, našpi-a	našpa
naž-āg-i, nažāgi	nažāgi
naḫḫ+a+šše-na, naḫḫ-a-šše-na	naḫḫaššina
naḫḫ+o+bade-ož	naḫḫubaduž
naḫḫ+o+že-a, naḫḫ-ož-a	naḫḫuža
naḫḫ+o+že-a, naḫḫ-ōž-a	naḫḫōža
naḫḫ+ō+tḫe-da, naḫḫ+ō+tḫe-i-da	naḫḫōtḫida
naḫḫ-a	naḫḫa
naḫḫ-a-b	naḫḫab
naḫḫ-i-l-āi	naḫḫilāi, nāġelāi
naḫḫ-i-le	naḫḫili
naḫḫ-ōž-u	naḫḫōžu
negri	negri, nigri
nelġ-a, nelġi-a	nelġa
nera, nera-a, neri-a, nēr-a	nēra
nera-i, neri, nēr-i	neri, nēri
nera-i-da, niri-da, niri-i-da	nirida
nera-i-da, niri-i-da	nirīda
nera-i-da, nēr-ed-a, nēri-da, nēri-i-da	nērida
nera-iē-da, neri-ie-da	nerēda
nera-ra	nērara
nera-ve	nēravi
nera-ī-da, neri-i-da	nerīda
neġer+ni-a	neġirna
nešši	nešši, nēšši
nešši-a	nešša
nešši-b	neššib
nešši-da=l, nešši-i-da=l	neššidal
nešši-na	neššēna
nešḫi-na	nešḫina
nibri-a	nibra
nig-a, nigi-a	niga
nigallu-we	nigalluwe
nigalo-va	nigalōba
nikkal	nikkal
nikkal-už=l, nikkal=l	nikkalul
nil-ō-ež, nili-ōž, nēli-ōž	nilōž
ninuwa+ġe-ne-š=nna	ninuwaġinešša
ninuwa-va	ninuwava, ninuwāva
ninuwa-ve	ninuwāve, nīnuwave
ninuwa-ḫe-ve	nīnubapḫi
nippilova-a	nippilōva
nir+o+bāde	nerubādi, nirubādi
nir+že-da, nir+že-i-da	niržida
nir-i-b, niri-b	nīrib
niri-āe	nirāe
nirġi-a	nirġa
niv-ōž-ill-and-i-n, niv-ōž-ill-and-i=n	nivōžellandin
niviri-f-fe, niviri-iffe	niviriffi
niġar+že	niġarži
niġari	niġāri
niġari-na	niġarra
niġe	niġe, niġi
niġe-f-fe, niġe-iffe	niġeffi
niġe-iffe, niġe-p-pe	niġippi
noi-a=l	nōial
nor+i+ġe-ne, nor+i+ġe-ne-e	nōriġini
nubi	nūbi
nubi-n, nubi=n	nubin
nubi-nē-n	nūbīnīn
nubur+ni-a	nuburna
nudan+z+a+ġe-ī-va=an, nudan+z+a+ġe-ī-va=n	nudanzaġīvan
nul+ade-ne-ž	nuladenež
numri-i-ve, numri-ve	numribi
nur+ā+šše	nurāšše
nurandiġi-nna	nurandiġinina, nurandiġinna
nutk+i+ġe-a	nutkiġa
nuġ+o+ni-a=m	nuġunab
nuḫḫ+a+že	nuḫḫaže
nā-uff-a	nāuffa
nāb-u	nābu
nāie-na-āž-a	nāēnāža
nāie-ne-va	nāēniba
nāl-i, nāli, nāli	nāli
nāldiri	nāldiri
nāli-ne, nāli-ne-e	nālli
nāli-ne-ž	nālliž
nān-ašt-i	nānašti
nān-ed-i	nānidi
nān-i-ež, nāni-ž	nāniž
nān-ind-o-eš=nna	nāninduža
nān-ād-o-m	nanādum
nāri+šše	nārišše
nāū+nni	nāwunni
nāū+nni-na	nāwunnina
nāž+ar+ni	nāžarni
nēb+ā+že	nēbāži
nēb+ā+že-a	nēbāža
nēd+o+ġē-ne-ž	nēduġēnež
nēl-a-b=an, nēla-b-a=an, nēla-b-a=n, nēla-b=an, nēli-a-v=an, nēli-a=v=an	nēlaban
nēli	nēli
nēli-a	nēla
nēli-na, nēli-na	nēlla
nēli-ōž	nēlōž
nēr+ni	nērne
nēġār+že-a	nēġārža
nīn-ād-o-m	nīnādum
nīv+ar+i-i-ož	nīvarīuž
nīv+ā+že	nīvāži
nīġr+i+a+že-ī=l	nīġriažīel
nōdiri	nōdiri
nōv+ar+ē=m	nōvarēm
nōvi-a=ān, nōvi-ā=n	nōvān
nōġ-ind-o-ež	nōġinduž
nōġašše-ne, nōġašše-ne-e	nōġaššeni
nū-ind-o-ež	nuwinduž
nūd+o+že-a, nūd-ož-a	nūduža
nūd-o, nūd-u	nūdu
nūm-a, nūmi-a	nūma
nūrbi-ne-ž	nūrbiniž
nūv+a+ni-nē-ž=l	nūwannīel
nūv+ar+i-nē-va=an, nūv+ar+i-nē-va=n	nūwarrīvan
nūv+ar+i-nē-va=ān, nūv+ar+i-nē-vā=n	nūwarrīvān
obi-na	ubina
odip.šarri-n, odip.šarri=n	udipšarin
ol-a, oli-a	ula
ol-ō-eš=til, ol-ōšt-i=l	ulōštel
oli-a=ffa	ulaffa, ulappa
oli-ne, oli-ne-e	ulli, ōlli
oli-ne-ne, ōlli-ne, ōlli-ne-e	ōllini
oli-ne-va	ulliva
oll+uġ+o+že-ve-āe	ulluġužibāe, ulluġōžibāe
oll+uġ+o+že-ve-āi	ulluġužibāi
oll+uġ-i-aī=nna	ōlluġaīnna
oll+uġ-o-m	ōlluġum
oll+uġ-ož-ill-and-i-n, oll+uġ-ož-ill-and-i=n	ōlluġužellandin
oll+uġ-ož-ill-i-āi-n, oll+uġ-ož-ill-i-āi=n	ulluġužellāin
oll-o-l-ež	ulluliž
oll-uġ-ēd-i	ulluġēdi
olvi-ne-e	ōlbīni
olvi-ne-ē=ma	ūlvinēma
omini-a	umina
omini-na	uminna, ōmminna
omini-na-až-a=ma	uminnažama
omini-na-āž-a	uminnāža, umminnāža
omini-na-āž-e	uminnāži
omini-ne-e	ōmminni
omini-ne-vā	ōmmennivā
omini-ī-e, omini-īe	uminīe
ondu=l	undūl
ondu=ma	ōnduma
onnu	unnu, ōnnu
or+o+nni	urunni
or+o+nni-da, or+o+nni-i-da	urunnida
or+o+nni-i-až, or+o+nni-ia-ne	urunniaž
or+o+nni-n, or+o+nni=n	urunnin
or-o, or-u	uru
orurmili-ī-až	ururmilīaž
ove-ne-ž	ubinež, uwenež
ove=n, ub-ī-en, ub-ī=n, ubi-n, ubi-ī-n, ubi-ī=n, ubi=n, ubī-n, ubī-ī-n, ubī-ī=n, ubī=n	ubīn
oġ+ni	uġni
oġ+o+ni	uġōni
oġ+ō+šše-āi	uġōššāi
oġ+ōž+a+mā+šše	uġōžamāšši
ošt+a+šše-n, ošt+a+šše=n	uštaššin
ošt+i+ġe	uštiġi
ošt-a-b	uštab
ošt-an-ēd-i	uštanēdi
ošt-ed-i-a, uštedi-i-a	uštedia
ošt-i-ae	uštae
ošt-o, ošt-u	ōštu
ošt-ur-a-b	ušturab
ošt-ā-b	uštāb
pa+i+re-i=ma	pairima
pa+i+re-iffu-we	pairibuwi
pa+ilia-ne-ž	pailianež
pab+ni, paba+ni	pabni
paba+ni	pabāni
paba+ni, paba+ni-ne, paba+ni-ne-e	pābanni
paba+ni, paba+ni-ne-e	pabanni
paba+ni-na	pabanna, pābanna
paba+ni-na-aš-ta	favanašta
paba+ni-na-až-e	pabannaže
paba+ni-na-až-ož	pabannažuž
paba+ni-na-āž-e	pābannāže
paba+ni-ne-ž	pabanniž
padn-i, padni	padni
pag+a+mme-ož	pagammuž
paib.ebla-ž	paibiblaž
paib.ebla=an, paib.ebla=n	paibiblan
paini-b-a-ne=l	painibanel
paini-ne-va, pā+i+nni-i-a	pāinnia, pāīnnia
paini-ne-ž, pā+i+nni-i-ž, pā+i+nni-ž	pāinniž
pal-aġ-a, pal-aʾ-a, pal-aḫḫ-a, palaġi-a, palaʾe-a, palaḫḫi-a	palaġa
pal-i-a	palia
pal-i-kki=mma	pālikkamma
pal-i-o	paliu, pāliu, pāliw
pal-o-kko	pālukku
pal-ā, pāli-ā	pālā
panniri-a	pannira
par-i-a, pār-i-a, pāri-i-a	paria
par-ind-o-ež	pārinduž
pari-ož	paruž
pariss+ade	parissade
parzīgi-a	parzīga
parġi-da, parġi-i-da	parġida
pass-ūw-a	passūwa
passi-a	passa
patte	pātte
patte-ne, patte-ne-e	patteni, pāttini
paġ+and+ar+i-ne, paġ+and+ar+i-ne-e	paġandarri
paġ+li	paġli
paġari-na-āž-ož, paḫḫiri-na-āž-ož	paḫḫirāžuž
paġi-ž, pāġ-i-ež	pāġiž
paġmi	paġmi
paīnni-ne-ve-ož	paīnninibuž
pašš+ar+ugār+i-a, pašš-ar-ugār-a	paššarugāra
pašš+i+ġe-ia-ne	paššiġiani
pašši-na=mma	paššinamma
ped+ar+i	pēdāri
ped+ar+i-ne-ž	pēdarriž
ped+ar+i-ož	pēdaruž, pēdāruž
ped+ar+i-v-až-a	pidari⸢fa⸣ša
pen-d-o, pen-d-o, pen-d-u, pen-d-u, pen-id-o, pen-id-o, pend-o, pend-u	pendu
pen-ān-o-ež	pēnānuž
pend-a	penda
pend-a-b	pindab
pend-aʾ-ol-d-a	pindaulda
pend-i-l-eva-ž	pindilivaž
pend-id-o	pendidu
pend-iž-a	pendiža
pend-o-kko	pendukku
pend-o=n	pindun
pend-uġ-a	pendūġa
pend-ōl-i	pindōli
pend-ūw-a=lla	pendōvalla
pid+o+šše-da, pid+o+šše-i-da	piduššida
pid+uff-a	piduffa
pid-i-a, pīdi-i-a	pidia, pīdia
pig-a, pigi-a	piga
pil+āġ+i+šše+li+ġe-a	pilāġižiliġa
pili-na, pille-a	pella, pilla
pilla-nē-va	pillanēva
pille-ne-e	pellēni, pillēni
pindaia+ni-ne, pindaia+ni-ne-e, pindaia+nni	pindaianni
pir+ugāri-a, pir-ugār-a	pirugāra
pir-ed-a, piri-da, piri-i-da	pirida
piri-ne-e=v, piri-ne=v, pirr-i-b, pirr-i=v, pirri-b	pirrib
pirund+ō+ġe-a	pirundōġa
pitkiri-a	pitkira
pittugalli-i-až	pittugalliaž
pizigarra	pizigarra
pizigarra-ž	pizigarraž
piġ-ī-e, piġi-ī-e	piġīe
piġi-da, piġi-i-da	piġida
pišḫ-i, pišḫi	pišḫi
piž+ešḫ-o-m	pižešḫum
pižiri-ne, pižiri-ne-e	pižirri
pižāiš.pā-ne=l	pižāišpānel
poli-ne-ve-āe	pullibāe
poli-ne-ž	pullež, pōllež
powe-na-až-ož	pōenažuž
powe-na-āž-ož	puenāžuž, pōenāžuž
powe-ne, powe-ne-e	puweni
powe-ne-ve	pōenibi
pošš+i+nni, pōšši-nni	puššinni
pul+idi-ve-āe	pulidibāe
puli-ne-ž	pulliž
pur+bur+ni-ī-e, pur+bur+ni-īe	purburnīe
pur+i+rē+nni	purrēnni
pura+mmi-b	purammib
pura+mmi-iffu-wa=an, pura+mmi-iffu-wa=n	purammippuwan
purandi	puramdi, purandi
purandi-ne-ž=l	purandinel
puranziḫ-ve-na-āž-a	puranzipḫināža
purra-nna, purra=nna	purranna
purra-ve	purrābi, purrāvi
purra=n	purran
purġ-a, purġi-a	purġa
puss-a, pussi-a	pussa
put+t+i+ġe-i-ž, put+t+i+ġe-ž	puttiġiž
puġuiri-da=ma, puġuiri-i-da=ma	puġuiridama
pušši	pušši
pā-ašt-ō-m	pāštōm
pābel+ġe-a	pābelġa
pāeni-b	pāenib
pāeni-b=ma, pāeni-p-pa	pāenippa
pāini	paini
pāiri-na	pāirra
pāli	pālī
pār+i+r+o+ni-ne, pār+i+r+o+ni-ne-e, pār+i+r+o+nni	pārirunni
pār+i+že-a, pār-iž-a	pāriža
pār+i+že-i-nna, pāriže-nna	pāriženna
pār-a, pāri-a	pāra
pār-i, pāri	pāri
pār-ill-and-i-n, pār-ill-and-i=n	pārellandin
pār-ind-ō-ež	pārendūž
pār-iž-a=nna	farižanna, pārīžanna
pār-u	pāru
pārgi-i-až	pārgiaž
pārili	pārili
pārili-a	pārila
pārili-āi	pārilāi
pārizi-ne-ve-na=ma	pārizinivinama
pāttari-ne-ve	pāttarribi
pāttari-nē-da	pāttarrēda
pāttīvori-ne-va	pāttīvorriva
pāġ-ed-a, pāġi-da, pāġi-i-da	pāġida
pāġ-ed-aw	paġedab
pāġ-ed-ōw	pāġidō
pāġ-id-e	pāġidi
pāġ-ēd-a	paġēda, pāġēda
pāġ-ōž-a	pāġōža
pāġ-ū=ma	pāġūma
pāġani-a	pāġana
pāġi	pāġi
pāġi, pāġi-i-e, pāġi-ie	fāġie
pāġi-b	pāġib
pāġi-i-až-a	pāġiaža
pāġi-i-va, pāġi-va	pāġiba
pāġi-ī-da	pāġīda
pāġilāe-na	pāġilāena
pāšš+aḫḫ+i	pāššaḫḫi
pāšš+i+tḫe	paššitḫi
pāšš+i+tḫe-a	paššitḫa
pāšš+i+tḫe-ā=d, pāšš+i+tḫe=d	pāššitḫād
pāži-iē-ne, pāžē-ne, pāžē-ne-e	pāžēni
pāži-ne-da	pāžinida
pāži-āe	pažāe, pāžāe
pēd+uġ-a, pēd+uġ-a	pēduġa
pēri-ġē-na, pērġēna, pērġēni-a	pērġēna
pērġubi-a	pērġuba
pēġ-i, pēġ-i, pēġi	pēġi
pēġ-ol-a-b-a=lla, pēġulabi-a=lla	pēġulaballa
pēž-an-o-m	pēžanum
pīar-id-a, pīari-da, pīari-i-da	pīarida
pīari	piari
pīd+uġ-o, pīd+uġ-u	piduġu
pōnġi-b	pōnġib
pōr+idi-āi	pōridāi
pōranade-ne-va	pōranadeniba
pōss-o, pōss-u	pōssu
pōšši	pōšši
pōšši-b	pōššib
pūd+ang-i-āi	pūdangāi
pūrānadi	pūrānadi
pūz+iġ-o-m	pūziġub, pūziġum
sabal+gi-na	sabalgina
sabal+gi-āi	sabalgāi
sabari-ne, sabari-ne-e	sabarri
sabl+a+šše	sablašši
sabl+ung+i	sablungi
sabl-ōž-a	sablōža
sabl-ōž-o	sablōžu
sabri	sabri
sakkandi	sakkandi
sal-ašt-o, sal-ašt-u	salaštu
sal-ī, sāli-ī, sālī	sālī
salmi-a	salma
samm+al-ašt-o-ež	sammalaštuž
sangandi	sangandi
sanzāmi	sanzāmi
sarmade-ne-n	sarmadenin
sassi+ni-ī-e, sassi+ni-īe, sassi-ne-ē	sassinīe
sav-āl-d-o-m	savāldum
saz+ul+di-a, sāz-ol-d-a	sazulda
sažri-a	sažra
saḫḫi-ā	saḫḫā
selmi	selmi
serrē-ne-ž	serrēnež
si-īa-ni	sīani
sib+ar+i-i-va, sib+ar+i-va	sibariba
sib-i, sibi	sibi
sig+al-d-i, sigaldi	sigaldi
sig+al-d-ož-i, sigald+o+že	sigalduži
sig+ar+ulli-ne-ž	sigarullinež
sigr+ō+šḫe-ne-e=nna, sigr+ō+šḫe-ne-nna, sigr+ō+šḫe-ne=nna	sigrōšḫinenna
sikk+o+ġe-a, sikk-ōġ-a	sikkōġa
sikk-ulli	sikkulli
sikk-ūlli	sikkūlli
silm+an-ed-aw	silmanidab
simidadi-a	simidada
simidadi-ne-ž	simidadinež
simidadi-ož	simidaduž
simmi-ne-ve, simmi-ne-ē, simmi-nē	simminie
sips+i+ḫḫe-a=tta	sipsiḫḫatta
siss-ō-m	sissōm
sitk-a-b	sitkab
sitk-ōl-i	sītkūli
sub-et-t-a, subitti-a	subitta
subn-ī-a, subni-ī-a	subnīa
sug-uġ-ēd-a	suguġēda
suga+zūg-an-i-šše-a, suga+zūga+ni+šše-a, suga+zūga+ni-š=nna	sugazūganišša
sugm-ušt-a-b	sugmuštab
sukk-i, sukki	sukki
sul+gi	sulgi
sul+ud-a	sulūda
sul+ud-e, sūl+ūde	sūlūde
sul+ud-ol-o-m	suludulub
sul+ud-ō-ēn	sulōdōēn
sul+ō+že-ne-ve, sul+ō+že-ne-ē, sul+ō+že-nē	sulōženie
sumġar	sumġar
suppi-ne, suppi-ne-e	suppini
suppi-ne-ve-ne-n	suppinibinin
sur+u+ški	suruški
sur+ung+i	surungi
sur-ōž-a	surōža
surgi	surgi
suss+ō+nni	suzōnni
suv+ad+atte	suwadatte
suwaḫḫu	suwaḫḫu
suzumagi-ia-ne	suzumagiani
suġižali-ne, suġižali-ne-e, suġižalli	suġižalli
suġri	suġri
suḫḫi-ne-ē, suḫḫi-nē	suḫḫinie
sāllavi-a	sāllava
sāss+ar+i	sāssari
sāz-i-en, sāz-i-en, sāz-i=n, sāz-i=n, sāzi-n, sāzi=n	sāzin
sāz-ol-i-a	sāžulia
sāz-ol-il-ed-a	sāzulilida
sāz-ol-ōšt-i-re	sāzulōšteri
sāz-ol-ōž-a	sāžulōža
sāz-ōl-ošt-i-re	sāzōlušteri
sāzalla-ž	sāzallaž
sēze	sēze
sēži	sēži
sīg-il-a, sīgili-a	sīgila
sō-ī-b, sōī-b	sōīb
sōbi-nē-ra	sōbinēra
sōbāri-a	sōbāra
sōni-ne, sōni-ne-e	sōnni
sōpḫōri-a	sōpḫōra
sōr-ōž-o	sōrōžu
sōve-ne, sōve-ne-e	sōveni
sōšš-a, sōšši-a	sōšša
sōšši	sōšši
sōšši-i-ož	sōššiuž
sūgētte-ne, sūgētte-ne-e	sūgētteni
sūl+eški-a	sūleška
sūl-id-o	sūldu, sūlidu
sūl-ōž-a	sūlūža
sūr+ang+i	sūrangi
sūve	sūwe
sūve-ae	sūwae
tab+i+re-iffu-we	tabiribuwi
tab+i+re-ī=ma	tabirīma
tab+i+rē+nni	tabrēnni
tab+ilia-ne-ž	tabilianiž
tab-ašt-i-le, tav-ašt-i-le	tabaštili
tab-ind-o-ež	tabenduž
tab-ož-o=d=am, tab-ož-ud-a=m	tābužudam
tab-ī-o	tābīw
tab-ōž-o=d=am, tab-ōž-ud-a=m	tābōžudam
taba+li-ne-ž	taballiž
tabakki-a	tabakka
tabrani	tabrāni
tabrani-a	tabrāna
tabri-a	tabra
tabrini-ne-ž	tabrinnež
tad+a+ni-da, tad+a+ni-i-da, tad-an-ed-a	tadanida
tad+ir+e+ški-ne-ve-āe	tadireškinibāe, tādireškinibāe
tad+ugar+i-āe	tadugarāe
tad+ugar+i-āi	tādugarāi
tad-id-a, tādi-da, tādi-i-da	tadida
tad-id-en, tatt-i-en, tatt-i=n, tatti-n, tatti=n	tattin
tado.ḫeba	tāduġeba
tado.ḫeba-va	taduġebāba
tado.ḫeba-ve	taduġebābi, tāduġebābi
tado.ḫeba=an, tado.ḫeba=n	taduġeban
tado.ḫeba=n	taduġevan, tāduġeban, tāduġebān
tag-o-l-aē-ž	tagulaēž
tag-o-l-āe-ž	tagulāež
tag-o-l-ēž	tagulēž, tāgulēž
tage+že	tagiže, tagēže, tāgiže, tāgiži
tage+že-na	tagižina
tagi	tagi, tāgi
tagi=ma	tagima
tal+āḫḫ-id-o	talaḫḫidu
tal+āḫḫ-o-m	talaḫḫum, talāḫḫum, tālāḫḫum
tal+āḫḫ-ī-b	tālāḫḫīb
tal-ašt-aw	talaštāw
tal-aḫḫ-ō-m	talaḫḫōm
tal-i, tal-i-le, tale, tāl-i, tāl-i-le	tali
tal-i-a, tale-i-a, tāle-i-a	tālia
tal-ā=lla, tale-ā=l, tāl-ā=l, tāle-ā=l	tālāl
tal-ī-a	talīa
tal-ōl-īž-a=nna, tāl+ūl+ī+že-a=nna	tālūlīžanna
talam+d-i-b, talam+d-i=v, talam+di-b	talamdib
tale, tāle	tāli
tale-b=ma, tale-iffe-a, tale-p-pa, talippi-a, tāl-i-b=ma, tāl-i=ffa	talippa
tale-ne-ž	talēnež
talm+a+ni-a=lla	talmanalla
talm+oḫḫe-a, talm-ōġ-a	talmōġa
talm-ašt-i	talmašti
talm-ašt-ī-le	talmaštīli
talm-d-o-m	tālamdub
talm-o, talm-u	talmu
talm-ōl-a	talmōla
talmošše-ne	talmuššini
talmōv-a-b	talmōvab
talāv+a+že	talāvaže
talāv+o+že	talavoži, talāvuži
talāv+o+že-na-až-a	talabōžinaža
talāv+o+že-na-až-ož	talabōžinažuž
talāv+o+že-na-āž-e	talavožināži
talāv+o+že-na-āž-ož	talābōžināžuž
tam+a+šše-na	tamāššina
tam+ar+i-na	tamarra
tamgina	tamgina
tamgina-ž	tamginaž
tamgāri-da, tamgāri-i-da	tamgarida
tamgāri-ne-da	tamgarrida
tami-a	tāma
tamm+ar+ġe	tammarġi
tammaderi-na	tammaderra
tamr-i-an, tamri-i-a=an, tamri-i-a=n	tamrian
tamri-a	tamra
tamri-ī=l, tamri-ž=l	tamrīl
tanni, tāni-ne, tāni-ne-e	tānni
tanni-a, tāni-na	tanna
tanāni-na	tanānna
tap-t-an-i, tapt+a+ni, tapt-an-i	taptani
tapti	tapti
tapti-ne, tapti-ne-e	tapteni, taptini
tapš+aġ+o+ḫḫe-a	tapšaġuḫḫa
tapš+ur+že-a	tapšurža
tapš+ur+že-ai	tapšuržai
tapš+āġ+i-a	tapšaḫḫa, tapšāġa
tapš+āġ+i-na	tapšāġina
tapš+ō+bāde	tapšōbādi
tapš-a-b	tapšab
tapš-ū	tapšū
tapḫ-ašt-i-b	tapḫaštib
tapḫi-a	tapḫa
tar+i+nni	tārinni
tar+i+nni=ma	tarinnima
tar+i+pt+i	taripti
tar+i+ġe-ne, tar+i+ġe-ne-e	tariġini, tāriġini
tar+ġe	targi
tarali-ne-ve	tarallibi
tarb-o, tarb-u, tarbu	tarbu
tarm+a+ni-na	tarmanna
tarm+a+ni-ne, tarm+a+ni-ne-e	tarmanni
tarm+a+ni-ne-ve-na	tarmannibina
tarm+a+ni-ož	tarmānuž
tarn-i, tarni	tarni
tarr-i-a, tarri-i-a, tāri-ne-va	tarria
tarve	tarve
tarē-na	tarēna, tārēna
tarže	tarže
taržuwa+n+zi	taržuwanzi
taržuwa+ni	taržuwāni, taržūwāni
taržuwa+ni-na	taržuwanna
taržuwa+ni-na-až-a	taržuwannaža
taržuwa+ni-na-až-e-āe	taržuwanažāe, taržuwannažāe
taržuwa+ni-na-až-ož	taržuwannažuž
taržuwa+ni-na-āž-a	taržuwannāža
taržuwa+ni-na-āž-e	taržuwannāži
taržuwa+ni-ne-da	taržuwannida
taržuwa+ni-ne-va	taržuwanniba
taržuwa+ni-ne-ve	taržuwannibi
taržuwa+ni-ne-ž	taržuwannež, taržuwanniž
tatḫi-ne-ve	tatḫinibi
tatḫi-nā=mma	tātḫināmma
taudi	tawti
tav-ašt-ō-m	tavaštōm
tav-ūd-o-m	tavūdum
tazakkašturi-a	tazakkaštura
taziri-a, šaziri-a	šazira
taġ+o+vadi-nē-da	taġuwadinēda
taġ+ā+že	taġāži
taġav+o+re, taġav+o+re-ne, taġav+o+re-ne-e	taġavure
taġōbi	taġōbi
taškar+ġe	taškarġi
taššāmi-b	taššāmib
taššāmi-ž	taššāmmiž
taž-ol-ūw-a	tažulūwa
taž-umme	tažummi
taže-ae	tāžae
taže-ne, taže-ne-e	taženi
taže-nē-ra	tāženēra
tažmi.šarri	tažmežarri
tažmi.šarri-da	tažmižarrida
tažmi.šarri-va	tažmižarriba
tažmi.šarri-ž	tažmižarriž
tažmi.šarri=n	tažmežarrin, tažmižarrin
te+o+n+āe	teunāe
te-i-a, tiye-a, tiye-i-a	tīa
te-i-a-ma, tē-i-a=ma, tēa=ma	tēama
te-ī-b, tiye-b	tīb
tebe-a, tive-a	teba
tebe-na	tebēna
tederi-a	tedera
teffe, tei-iffe	teffe
tei-ai, tive-ai	teiai
tel-i-b=ma	telippa
tel-o, tel-u	telu
tel-o-m=ma, tel-umme-a	telumma
tel-u	tēlu
tel-ī-b=ma	telīppa
tem+gi-i-až-a	temgiaža
temiġi-a	temiġa
temm+ā+ni, temm-ān-i	temmāni
teġ+ol+i-ne, teġ+ol+i-ne-e, teġ-ol-i-le	teġulli
teġ-ed-a	teġida
teġ-ed-a, teġidi-a, tēġi-da, tēġi-i-da	tēġida
teġ-ešt-a-b	teġeštab
teġ-ešt-o-m	teġeštub
teġ-i-o	teġiw
teġ-ull-a	tēġulla
teġr-i, teġri	teġri
tešš+o+ġe-āi	teššuġāi
tešš-už-o-m	teššužum
tešše	tešši, tēšši
tešše+ni, tešše-ne, tešše-ne-e	teššeni
tešše-i-e, tešše-ie	teššīe
tešše-na	teššena
tešše-na-āž-a	teššināža
teššob	teššub
teššob-až	teššōbaž
teššob-pe	tešcuppi, teššuppi
tež+o+ġe-āi	težuġāi
tež+uġ+ar+ġe	težuġarġi
tež+uġ+ar+ġe-da, tež+uġ+ar+ġe-i-da	težuġarġida
tež+uġ+ar+ġe-na-āž-e	težuġarġināži
teži-āe	težāe
teḫp-a, teḫpi-a	teḫpa
tib-a, tibi-a, tive-a	tiba
tibade=dilla	tibadedella
tibāġi-a, tiv-āġ-a	tibāġa
tid+i+vad+o+ḫḫe-a	tedevaduḫḫa, tidivāduḫḫa
tidi-a, tīd-a, tīd-a, tīd-a	tīda
tidi-da, tidi-i-da, tīd-id-a, tīd-id-a, tīd-id-a	tīdida
tidi-i-a=m, tīd-i-a=m, tīd-i-a=m	tidiam
tidi-i-ā=m, tīd-i-ā=m, tīd-i-ā=m	tidiāb
til+ol-ōšt-aw	tilulōštab
tilladi-a	tillada
timeri-ne-e	timarri
timeri-ne-ē	timerrē
tip+šari	tipšar, tipšari, tipšāri, tīpšāri
titt-a, titti-a, tīd-id-a, tīd-id-a, tīd-t-a	titta
tiv+o+šḫi	tibōšḫi
tiv+o+šḫi-a	tebušḫa, tivošḫa
tiv+o+šḫi-na, tiv+o+šḫi-ne-e	tivušḫini
tiv+o+šḫi-āi	tebušḫāi, tibušḫāi
tiv-a, tiye-i-va, tiye-v-a, tiye-va	tīva
tiv-āġ-id-o	tivāḫtu
tiv-āġ-ō-m	tibāġōm
tive	tebi, teve, tibi, tivi, tībi
tive-b	tibib
tive-f-fa, tive-iffe-a	teveffa
tive-na	tevena, tibina, tibēna, tivena, tivina, tēvena, tīvena, tīvina
tive-na-až-ož, tive-na-āž-ož	tebinažuž
tive-na-āž-ož	tebināžuž
tive-ne, tive-ne-e	tebini
tive-ne-va, tīvini-ne-va	tīvenniva
tive-ne-ž	tiveniž
tive-nā=m	tivinām
tive-v-uda=m	tivivudab
tive-ā	tīvā
tive-āe	tebāe, tibāe
tive-āi	tebāi, tibāi
tiye-a	tia
tiye-iē-a, tēa	tēa
tiz-ū	tizū
tišš+o+ḫḫe	tiššuḫḫi
tiža-b	tižab
tiža-b, tīž-a-b	tīžab
tiža-i-až	tižiaž
tiža-nna, tiža=nna	tīžanna
tiḫḫ-ed-a, tiḫḫi-da, tiḫḫi-i-da	tiḫḫida
tomn+adi-ne=lla	tumnadinella
tomni-i-a=m	tumniam
tomni-i-až-a	tumniaža
tomni-i-až-ōž	tūmniažūž
ton-i-le=ffa, tōn+ili-f-fa, tōn+ili-iffe-a	tōniliffa
ton-i-vade-ai, tūn-i-vade-ai	tunivadai
ton-i-āi-n, ton-i-āi=n, tūn-i-āi-n, tūn-i-āi=n	tūnāin
ton-id-o	tunidu
ton-ošt-o, ton-ošt-u, tūn-ušt-o, tūn-ušt-u	tunuštu
ton-āḫḫ-i, tōn+ā+ḫḫe, tōn+āḫḫ+i, tūn+ā+ḫḫe, tūn+āḫḫ+i, tūn-āḫḫ-i	tūnāḫḫi
ton-ō-m, tūn-ō-m	tunōm
ton-ōšt-o-m	tunōštum
tor+o+ḫḫe-na, tur+o+ḫḫe-na	turuḫḫina
tor+o+ḫḫe-āe	tōruḫḫāe
torove	tōruwe, tōruwi
torove-a, torv-a	turba
torove-ne-ve	tōrōbinibi
tuffaē+šḫe=ma	tuffaēšḫema
tug-a=lla, tugali-na, tugi-a=lla	tugalla
tugriž+ō+ġe-a	tugrižōġa
tugriž-ḫe	tugrišḫi
tui-i-va, tui-va	tuiba
tulbuli+m+a+že-a	tulbulimaža
tulburi-āe	tulburāe
tuli-ne-ve-na, tulli-ve-na	tullibina
tummi-ne-e=nna, tummi-ne-nna, tummi-ne=nna	tummininna
tun+i+tḫe-iffe	tunitḫibe
tunuwari-ne-ž	tunuwarriž
tuppi-ne-e	tuppini
tupḫ-a, tupḫi-a	tupḫa
turb+ō+re	turbōri
turžē	turžē
tuw+ar+ni-ve-ne-da	tuwarnibinida
tā-ūmb-a=lla	tāwumballa
tād+ar+e+ški	tādareški
tād+i+a+šše	tādiašši
tādi-a	tāda
tādi-ne-vā=d	tādinibād
tādi-āe	tadāe
tāditti+ni-i-a=lla, tāditti+ni-i-až=lla	tādittiniala
tāg+ō+re	tāgōri
tāgidu-ra	tāgidura
tāle-na	tālina
tāle-na-až-a	talinaža, talēnaža
tāle-na-āž-a	tālināža
tāle-ne-va	taliniba
tāle-ne-ž	tālēnež
tāle-nē-da	tālinēda
tān+gi-ai=mā	tāngaimā
tān+o+že	tānuže
tān-a	tā+na
tān-a, tāni-a	tāna
tān-ašt-ī-b	tānaštīb
tān-d-i-b	tāndib
tān-d-o, tān-d-u, tān-id-o	tāndu
tān-i, tāni	tāni
tān-ož-i	tānuži
tānu	tānu
tānumāgi-āi	tānumāgāi
tāpš-ōl-āw	tāpšūlāw
tār+ō+ni, tār-ōn-i	tārōni
tār-a, tāri-a	tara
tār-a, tāri-a, tāri-a	tāra
tāri	tāri
tāri-ai, tāri-āi	tarāi
tāri-na	tārra
tāri-ne, tāri-ne, tāri-ne-e, tāri-ne-e	tārri
tāri-ne-ž	tarriž, tārrež, tārriž
tātḫ+und+ō+re-na=mma	tatḫundōrinamma, tātḫundōrinamma
tāġ-a, tāġe-a	tāġa
tāġ-až-ī-b	taġažīb
tāġ-i, tāġ-i, tāġe, tāġe	tāġi
tāġani-na	tāġanna
tāġe	tāġe
tāġe-i-va, tāġe-va	tāġiba
tāġe-ne-va	tāġiniba
tāġe-ne-ve-ne-ž	tāġinibinež
tāġe-ne-vā=l	taġēnivāl
tāġe-ne-ž	taġinež, taġēnež, tāġinež
tāġe-ve	tāġibi
tāġe-ve-āe	tāġibāe
tāġe-ve-āi	tāġibāi
tāġe=d	tāġid
tāġe=ma, tāġe=ma	tāġēma
tāži-ne, tāži-ne-e	tāžini
tāžē-ne, tāžē-ne-e	tāžēni
tē+ni	tēni
tē+ni-a, tēni-a	tēna
tē-i-a	teeia
tēi	tē
tēi+ade-n, tēi+ade=n	tēadin
tēġ+o+šše-n(e)-e, tēġ+o+šše-ne	tēġuššeni
tēġi-i-až-a	teġiaža
tīd-i-kki	tidikki
tīd-i-o, tīd-i-o, tīd-i-o	tīdiw
tīd-i-vāde	tīdivāde
tīd-išt-ēd-i	tidištēdi
tīv-o=lla=an, tīv-oll-a=an, tīv-oll-a=n, tīvoli-na=an	tīvollan
tōbi-na-až-ož	tubinažuž, tōbinažuž
tōbi-na-āž-ož	tōbināžuž
tōbi-āe	tōbāe
tōmmo+šše	tōmmušše
tōmv-a	tōmva
tōpš-ed-a, tōpši-da, tōpši-i-da	tōpšida
tōġ+ad+om+a+ni-ne, tōġ+ad+om+a+ni-ne-e, tōġ+ad+om+a+nni	tōġadumanni
tōġ-ad-i-b	tōġadib
tōġ-ad-ož-i-l-āi	tōġadužilāi
tōġ-ad-uffu	tōġaduppu
tōġal+zi-ne-va	tōġalziniba
tōġal+zi-ne-ž	tōġalziniž
tūdi+gi-ož	tūdiguž
tūdi+gi-ōž	tūdigōž
tūn+imm+o+šš+oḫḫe-a	tūnimmuššuḫḫa
tūn-id-o	tūnidu
tūni-ia-ne	tūniani
tūnuw-ad-o, tūnuw-ad-u	tūnuwadu
tūr+o+ḫḫe	turuḫḫe, tūruḫḫi
tūr-i, tūri	tōri, tūri
tūri	tūria
tūri-n, tūri=n	tūrīn
tūri-ī-e, tūrī+e	tūrīe
ub+ugar+že-ne, ub+ugar+že-ne-e	ubugarženi
ub-a, ubi-a, ubī-a	uba
ub-ind-i-ai-n, ub-ind-i-ai=n, ubindi-ai=n	ubindain
ub-o-kko	ubukku
ub-o-m	uwom
ub-o-va-en	ubuwen
ub-ēd-a	ubēda
ub-ō-m	uwōm
ub-ōž-a, ub-ōž-a	ubūža
ubi	ubi
ubilbaeži	ubilbaeži
ubilbaeži-ne-ž=l	ubilbāeženel
ubip.tēšši-ž=l	ubiptēššel
ud-ad-i-l-āi=v, udadeli-āi=v	udadelāib
ud-ož-o=d=amma, ud-ož-ud-a=mma	udužudamma
ud-ān-a-b	udānab
udip.šarra-a=an, udip.šarra-a=n, udip.šarra=an, udip.šarra=n	udipšarran
udip.šarra-ž=l	udepšarrāl
ue, uwi	ue
uenawa	uenava
uenawa-ž=l	uenaval
ug+ol+gar-i	ugulgari
ug+ol+z+i+ġe-ia-ne	ugulziġiani
ug+ol+z-i-b	ugulzib
ugulg-o=l, ugulg-u=l	ugulgul
ukk-o, ukk-u, ukku	ukku
ul+ān-ō-m	ulānōm
umb+und+o+re-ne-da=l	umbundurinidal
umb-iž-a, ūmb+i+že-a	ūmbiža
umb-ō-ež, umbi-ōž	umbōž
umba=an, umba=n	umban
umbu	umbu
umm+all+id+a+šše, umm-all-ed-a-šše	ummallidašše
umm-an-a, ummani-a, ummani-a	ummana
umm-an-id-o	ummandu, ummanidu
umm-o-m-a-šše-ne-va, umm-o-m-a-šše-ne-va, ūmm+um+a+šše-ne-va	ūmmumaššiniva
umm-ēġ-a	ūmmēġa
umve	umve
un+i+ġe-i-ž, un+i+ġe-ž	uniġiž
un+i+ġe-ia-ne	uniġiani
un+o+šḫe-ož	unušḫuž
un-a	una
un-a=dil	unadel
un-a=m, un-a=m	unam
un-i-b	unib
un-i-eva=d=ān	univadān
un-i-eva=tta	univatta
un-i=l	unel
un-o-ež	unuž
un-īd-o	unīdu
un-ōž-i	unōži
univi-i-a	univia
ur-a, uri-a	ura
ur-i, ur-i, ur-i, ure, uri, uri	uri
ur-i-o	uriu
ur-o-kko	urukku
ur-uw-a	uruwa
ur-uġ-ed-a	uruġeda, uruġida
ur-uġ-ēd-a	uruġēda
ur-ō-kko	urūkku
uraē-na	uraēna
ure-a	uria
ure-na	urina
ure-āe	urāe
urgi	urgi
urgi-na	urgina
uri-b-a, uri-i-va, uri-va	uriba
uri-i-da	urida
uri-i=l	urel
uri-ī-da	urīda
urūbi	urūbi
utḫari-na	utḫarra
uw+all+i+nni, uwalli-nni	uwallinni
uw+ar+i+nni-nā=ma	farinināma
uw+ett+a+ni	uittani, uēttani
uw+o+ni-a	ūna
uw+o+že-a=mma, uw-ož-a=mma	ūžamma
uw+o+že-i-a	ūžia
uw+ētt-a, uwētti-a	uētta
uw-a=l, uwi-a=l	uwal
uw-i, uwi-a=m	uwamuwā
uw-il-an-o-m	uilanum
uw-ā=l, uwi-ā=l	uwāl
uwer+o+ḫḫe-ā=l	ueruḫḫāl
uwi	ui
uwi-a	uwa
uwi-b	uīb
uwi-na-āž-a, uwi-na-āž-a	uwanāža
uwi-ne, uwi-ne-e	ueni
uwi-ne-ž	uinež
uwi-ā	uwā
uwi-ž	uīž
uwēkki	uēkki
uwīri-ne-ve-na-āž-a	uīrrivenāža
uzi	uzi
uġari-na	uġarra
uġi	uġi
ušš+e+šše-ne-da	uššeššinida
ušš+i+ġe-na	uššiġina
ušš-o-l-ēž	uššulēž
ušš-ō-m, ōšš-ō-m	uššōm
ušḫ+ār+i-ī-da	ušḫārīda
ušḫ-ol-uffu	ušḫuluppu
ušḫu+ni	ušḫuni, ušḫōni
ušḫu+ni-ne-vā=l	ušḫunnibāl
ušḫu+ni-āe	ušḫunāe
ušḫu+ni-ōž	ōšḫunōž
ušḫu+ni-ž	ušḫunež
už+o+ni-a, už-ōn-a	užōna
už+o+ni-ne-ve-na, už+o+nni-ve-na	užunnibina
už-a, uži-a	uža
už-u	užu
uže-ne, uže-ne-e	uženi
ābē-ne, ābē-ne-e	ābēni
ākki	akki, ākki
ālla+i	allai, allāi
āllāni	allani, āllāni
āllāni-ne-da	allannida
āllāni-ne-e	āllānni
āllāni-va	āllaniva
āllāni=ma	āllānima
ālv-a, ālvi-a	ālva
ālz-i-b	ālzib
ālžīālli	alzialli, ālžialli
āmb-a, āmbi-a	āmba
āmm+a+nni-ne-va	āmmanniniva
āmmī-n-ī=n, āmmī-nē-n	āmmīnīn
āni	āni
ānnu, ānnu	ānnu
ānž+ali-ā=l, ānž-al-ā=l	ānžalāl
āpsukki-ož	āpsukkuž
ārari	ārari
āri-ne-da	ārrida
ārni-i=l	ārnil
āss+ar+ō+ḫḫe-a	āssarōḫḫa
āġmižari-ne-ž	āġmižarriž
āġr-ud-o-m	āġrudum
āšt+a+šḫe-ne, āšt+a+šḫe-ne-e	āštašḫini
āšte	āšte
āšte, āšte-i	āšti
āšte-a	āšta
āšte-b=ma	āštippa
āšte-i-nna, āšte-nna	āštenna
āšte-na	aštēna
āšte-ne-va	ašteniva
āšte-ne-va=an, āšte-ne-va=n	āštenivan
āšte-ne-ve	āštenibi
āšte-nna, āšte=nna	aštenna
āšte-va	āštiba
āšte-ī-va	āštīva
āšš-an-i-eva, āššani-b-a, āššani-i-va, āššani-va	āššaniba
āšš-i-ae-ž-a=l	āššaežal
āšš-id-en	āššiden, āššidin
āšš-ō-l-āe-ž	āššōlāež
āšši-a	āšša
āššōri-ve	āššōribi
āšḫ+i+tḫe-ne, āšḫ+i+tḫe-ne-e	āšḫitḫini
āšḫ+ož+i+kk+o+nni	ašḫužekkunni, ašḫužikkunni, āšḫužikkunni
āšḫ+ož+i+kk+o+nni-da	ašḫužikkunnida
āšḫ+ož+i+kk+o+nni-ne-va	ašḫužikkunniniba
āšḫ+ož+i+kk+o+nni-ne-ve	ašḫužikkuninibi, ašḫužikkunninibi, āšḫužikkunninibi
āšḫ+ož+i+kk+o+nni-ne-ve-ne-da	āšḫužikkunninibinida
āšḫ+ož+i+kk+o+nni-va	ašḫužikkunniba
āšḫ+ož+i+kk+o+nni-ve	ašḫužikkunnibi
āšḫ+ož+i+kk+o+nni=ma	ašḫužikkunnima, āšḫužikkunnima
āšḫ+ō+m+ai+ni-ve-ne-da=l, āšḫ+ō+m+ai-ne-ve-ne-da=l	āšḫōmainibinidal
āšḫ-o-ež	āšḫuž
āšḫ-ō+m+ai-n, āšḫ-ō+m+ai=n	āšḫōmain
āšḫi-a	āšḫa
āšḫi-ne-va	āšḫiniba
āšḫi-ī=ma	āšḫīma
āšḫo+e	ašḫuwe, āšḫuwe, āšḫuwi
āže	āže
āžri	āžri
ēar+že	ēarži
ēari-ne-ve-na=ma	ēarrivenama
ēari-ž	ēārež
ēbla	ēbla
ēbla-va	ēblava, īblaba
ēbla-ā=l	ēblāl
ēbla=m	ēblam
ēbla=n	ēblan
ēlgi, ēlgi-i	ēlgi
ēlgi-i=lla, ēlgi=lla	ēlgilla
ēlgi-āe	ēlgāe
ēnġi-a	ēnġa
ēpp+i+re	ēppiri
ēpḫe-ne	ēpḫēni
ēpḫe-ne-dan	ēpḫenidan
ēr-d-o-kko, ērd-o-kko	ērdukku
ērbiri-iffe, ērbiri-p-pe	ērbirippi
ērn-i, ērni	ērni
ēšḫ-i, ēšḫi	ēšḫi
ēḫḫi-a	ēḫḫa
ēḫḫi-ne-ž	ēḫḫinež
īa	īa
īa=d	īād
īa=d, īa=d	īad
īa=ma	īama
īa=mma, īa=mma	īamma
īani	īani
īll+uli-i-a, īll-ol-i-a	īllulia
īnna=nna=m	īnnannam
īpšade-ne-n	īpšadenen
ōl+mi-a, ōlm-a, ūl+me-a	ōlma
ōl+mi-šši	ōlmišši
ōll+o+ḫḫe-a	ōlluḫḫa
ōr+d-a-b, ōr+d-a=m	ōrdab
ōr+d-a=ffa=nan, ōr+d-a=ffa=nan	ōrdappanan
ōr+d-i-eva	ōrdeba
ōr+d-ō-bōr	ōrdōbōr
ōr+d-ō-ež	ōrdōž
ōrgi-ne	ōrgini
ōrgi-ne-n	ōrginin
ōġ+ni	ōġni
ōšt+a+nn+ō+ġe-a, ōšt+ann-ōġ-a	ōštannōġa
ōšš+o+ni-i=lla, ōšš-un-i=lla, ōšš-un-il-a, ōššunili-a	ōššunila
ōšš+o+že-a=nna, ōššuž+a+ni-na, ōššuž+a+nni-a	ōššužanna
ōšš-e	ōšše
ōšš-i, ōšš-i, ōšš-i, ōšš-i, ōšši	ōšši
ōšš-o-kko=m	ōššukkam
ōšš-ī=d	ūššīd
ōšš-ō+m+ai	ōššōmai
ōšš-ōšt-i	ōššōšti
ōžni-ai	ōžnai
šab+al+a+ni-da, šab+al+a+ni-i-da	šabalanida
šabad+ni=mma	šabadnimma
šabeni-āe	šabenāe
šabinuwa-ġe-ne-ve-na	šabinuwaġinibina
šabinuwa-ġe-ne-ž	šabinuwaġinaž
šabur+ni-a	šaburna
šad-ō-m	šadōm
šad-ōž-i	šadōži
šadani-ne-ž	šadanniž
šadani-ž	šadānež
šaderi-da, šaderi-i-da	šaderida
šadn-a, šadni-a	šadna
šag+ar+i-ī=lla	šagarēlla
šag+um+že-ne-ž	šagumženež
šag-ož-ill-and-i-n, šag-ož-ill-and-i=n	šagužellandin
šallae-na	šallaena, šāllaena
šallae-ne-n	šallaenen
šallaie-ne-e=l, šallaie-ne=l	šallaēnel
šalġ-o-l-ēž	šalġulēž
šalġ-ōl-a	šalġōla
šapḫaldi-b	šapḫaldib
šarn+i+tḫe	šarnitḫe
šarr+a+šše	šarrašši
šarr+a+šše-ne-e=n, šarr+a+šše-ne-n, šarr+a+šše-ne=n	šarraššinin
šarr-a, šarri-a	šarra
šarr-i, šarri, šāri-ne, šāri-ne-e	šarri
šarri-i-až	šarriaž
šarri-na	šarrina
šarri-na, šarri-na, šarrē-na	šarrēna
šarri-na-āž-e	šarrināže
šarri-ne-da	šarrinida
šarri-ne-va	šarriniba
šarri-ne-ve	šarrinibi
šarri-ne-ž	šarrinež
šarrumma=n	šarrumman
šarāmmē-ne, šarāmmē-ne-e	šarāmmēni
šarārmi-a	šarārma
šarže-a	šarža
šaržārai=ma, šaržāraima	šaržāraima
šattaġamōri-a	šattaġamōra
šatti, šātt-i	šatti
šatti, šātt-i, šātt-i	šātti
šatti=dil	šattidel
šauri-a=lla	šāwralla
šav+ō+že-ne-va	šavōžiniva
šavad+ni=mma	šavadnimma
šavli-a	šabla
šavli-na	šavālla
šavli-na-āž-e	šavallāži
šavli-ne, šavli-ne-e	šāvālli
šavli-ne-e	šaballi
šavli-āe	šablāe
šavoška	šauška
šavoška-da	šauškada, šauškāda
šavoška-va	šavuškava
šaġad+n+adi	šaġadnadi
šaġurunuwa-va	šaġurunuwaba
šašfe, šašfe	šašfe
šaž-an-ō-eva	šažanōva
šažari-ne, šažari-ne-e	šāžarri
šažari-ne-e	šažarri
šeb+ār+i-a, šeb-ār-a	šebāra
šel+o+že-ē-da, šel+o+žē-da, šel-ož-ēd-a	šelužēda
šel-a, šeli-a	šela
šel-ōl-id-o	šelōlidu
šell+o+ġ+l+o+pše-ne-ve, šell+o+ġ+l+o+pše-nē, šell+o+ġ+l+o+pše-nē-e	šelluġlupšenie
šell+o+ġ+o+li-na	šelluġulla
šell+o+šše-ae	šelluššae
šell+o+šše-āi	šelluššāi
šelli	šelli
šelli-a	šēlla
šelli-da, šelli-i-da	šellida
šelli-n	šellin, šēllin
šelli-ne, šelli-ne-e	šellini
šen+z+ūwi-a=tta	šenzūwatta
šena	šena
šena-i, šeni, šiye-ne, šiye-ne-e, šēn-i	šēni
šena-iffe	šeniffi, šēniffe
šena-na, šeni-na, šēn+ni-a, šēnni-a	šēnna
šend-ur-o-m	šendurum
šendamenni=n	šendamennīn
šer+ġe-ož, šerġi-ož	šerġuž
šer+že	šerže
šer+že-ne, šer+že-ne-e	šēržēni
šer+že-ne-e	šerženi, šērženi
šer-ed-aw	šeridab
šermin+ġe-a	šerminġa
šermin+ġe-ne-ž	šerminġinež
šervi-na-až-a	šervinaža
ševeri-na-āž-e	ševerrāže
šeġ+l-a, šeġl-a, šeġli-a	šeġla
šeġ+l-u	šeġlu
šeġal+a+šše+ġe-ne-e=mma, šeġal+a+šše+ġe-ne=mma	šeġalaššiġinimma
šeġal-a	šeġāla, šiġāla
šeġal-a, šeġali-a	šeġala, šēġala
šeġal-a=m, šeġali-a=m	šiġalam
šeġal-a=ma, šeġali-a=ma	šeġalama
šeġal-a=mma, šeġali-a=mma	šeġalamma
šeġal-ašt-a=ma	šēġalaštama
šeġal-ind-o-ež	šēġalinduž
šeġal-o-ež	šeġaluž
šeġal-o-l-ae-š=nna	šēġalulaešša
šeġal-o-l-aē-ž	šeġalulaēž
šeġal-o-l-āe-š=nna	šeġalulāešša
šeġal-o-l-āe-ž	šeġalulāež
šeġal-o-l-ēž	šeġalulēž, šēġalulēž
šeġal-o-m	šēġalum
šeġal-o-m-a=lla	šeġalummālla
šeġal-o-m-a=lla, šeġal-umme-a=lla	šēġalumalla
šeġal-ol-a=m	šeġalulam
šeġal-ož-ill-and-i-n, šeġal-ož-ill-and-i=n	šeġalužellandin
šeġal-ud-i-ež	šēġaludiž
šeġal-ā	šeġalā
šeġal-ō-l-ež	šeġalōlež
šeġali	šēġali
šeġel+zi-a	šeġelza
šeġiri-a	šeġira
šeġli-na	šeġella, šeġellina
šeġli-ne-e=dil, šeġli-ne-ne=dil, šeġli-ne=dil	šeġellinidel
šeġli-ne-ve-na	šeġellibina, šeġellivina
šeġli-ne-ve-na-až-ož, šeġli-ne-ve-na-āž-ož	šeġellibinažuž
šeġli-ne-ve-āi	šeġellibāi
šeġor+n+i+nni, šeġor+ni-nni	šeġurninni
šeġor+ni	šeġurni, šeġōrni
šeġor+ni-da, šeġor+ni-i-da	šeġōrnida
šeġor+ni-i-va, šeġor+ni-va	šeġurniba
šeġor+ni-ne-ve-ne-e	šeġurunnivini
šeġor+ni-ve-ne-e	šeġurnibini
šeġor+ni-ve-āe	šeġurnibāe
šeġor+ni-āe	šeġurnāe, šēġurnāe
šeġr+oli-i-da, šeġr-ol-ed-a	šeġrulida
šeġr-i, šeġri	šeġri
šeġr-o-ež, šeġri-ož	šeġruž
šeġōni-na-āž-a	šeġōnāža
šešfe	šešfe
šešti-na	šeštena
šešti-ne, šešti-ne-e	šešteni
šeštuġ+al+zi-ne, šeštuġ+al+zi-ne-e	šeštuġalzini
šeššali-ne, šeššali-ne-e, šeššalli	šeššalli
ši-a, ši-i-a, šiye, šiye-a, šiye-i-a, šī-a, šī-i-a	šia
ši-ur-i-va-en	šiurivain
ši-ūmb-a=lla	šiwumballa
šial-i-re-iffu-we	šialiribuwi
šial-ož-o-m	šialužum
šial-ē-re	šialēri
šial-ōž-o-m	šialōžum
šiali	šiali
šib-ā, šibi-ā	šibā
šid+ar+ni	šidarni
šid+ar+ni-a	šidarna, šidārna
šid+ar+ni-ai	šidarnai
šid+ō+ri	šidōri
šid+ō+ri-ne-va	šidurriva
šid-ar-ill-ō-m	šidarillōm
šid-i-l-āi	šidilāi
šid-ār-a	šidāra
šidarbu	šidarbu
šidarbu-ž=l	šidarbul
šig+adi-i-va=m, šig+adi-va=m	šigadibam
šigl+ade=mma	šiglademma
šikki-na-až-a=an, šikki-na-až-a=n	šikkinažan
šil+um+ō+tḫ-i-b, šil+um+ō+tḫe=m	šilumōtḫeb
šil-aġ-ugar-i=lla	šilaġugarilla
šil-d-an-ur-o-m, šild-an-ur-o-m	šildanurum
šil-āġ-i, šilāġi	šilāġi
šilaluġi-ne-da	šilaluġinida
šilavi-a	šilava, šilāva
šimi-ne-ž	šiminež
šimiga+i	šimegai
šimige	šimigi
šimige-ne=l	šimiginel
šin+z+o+ḫḫe-a=mma	šinzuḫḫamma
šin+ze	šinzi, šīnzi
šin+ze-a=mma	šinzamma
šin+ze=ma	šīnzima
šind+ade-āi	šindadāi
šind-a, šindi-a, šindi-a	šīnda
šind-i-ež, šindi-i-ž, šindi-ž, šindi-ž	šindiž
šindai	šindai, šindāi
šindai=b, šindi-āi=v	šindāib
šindi+ššē-ne, šindi+ššē-ne-e	šendiššēni
šindi+ž+ūwi-a=d	šindižūwad
šindi-a, šindi-a, šindi-a	šenda
šindi-na	šendena
šine-āi	šināi
šini=m, šini=m	šinim
šini=ma	šinima
šini=mma	šīnimma
šini=mma=m	šīnimmab
šinnaġi+ni-iffe-až	šinnaġinippaž
šinubi-ne, šinubi-ne-e	šinubini
šinurġi-na	šinurġina
šinut-ḫe-na, šinutḫi-na	šinutḫina
šir+ad-i-le	širadili, šīrādili
šiya-ne-da	šianeda
šiye	šīe
šiye, šiye-a, šī-a, šī-a, šī-i-a, šī-i-a, šī-ī-a, šī-ī-a	šīa
šiye-a=d	šīad
šiye-ai	šiai, šīai
šiye-na	šēna, šīena
šiye-na-až-a	šīenaža
šiye-na-až-ož, šiye-na-āž-ož	šīenažuž
šiye-na-āž-a	šīenāža
šiye-na-āž-e	šīenāže
šiye-na-āž-ož	šeēnāžuž, šīenāžuž
šiye-ne, šiye-ne-e	šīeni
šiye-ne-aē=l	šīenaēl
šiye-ne-e=lla, šiye-ne-ž=lla, šiye-ne=lla	šīenella
šiye-ne-e=ma, šiye-ne=ma	šēnima
šiye-ne-āi	šīenāi
šiye-ne-ž	šīenež, šīeniž
šiye-ā=ma, šī-i-ā=ma, šī-i-ā=ma, šī-ā=ma	šiāma
šiye-āe	šīāe
šiye-āi	šiāi, šīāi
šiye-ž	šiēž, šīež
šiāni=ma	šiānima
šo-da	šōda
šo-ve-ae, šowa-ae	šōvae
šo-āž-uda	šāžuda
šokki	šukki
šokko	šukku, šōkku
šokko-a, šukk-a	šukka
šokko=nna, šukk+o+ni-na, šukk+o+nni-a	šukkunna
šolli	šōlli
šolli-ā=d	šullād
šowa, šowa-a	šōva
šowa-ai=v	šōvaib
šowa-da	šūwada
šowa-āe	šōvāe
šowala-da, šowali-a=tta	šōvalada
šowala-ž	šōvalaž
šu-i-nd-a-šše	šuwindašši
šu-i-ēž, šō-i-ēž, šōe-ž	šuēž
šubi-ne-va	šūbīniva
šubri+ana-ž	šubrianaž
šubri-ve	šubribi
šubri-ve-na	šubribina
šubri-ve-ne-va	šubribiniba
šubri-ve-ne-ve	šubribinibi
šubri-ve-ne-ve-na-āž-a	šubribinibināža
šubri-ve=ma	šubribima
šug+ārd-ed-āw=l	šugārdedāwul
šui-ne-ž	šuinež
šukk+utt-a=tta, šukk+utti-a=tta	šukkuttatta
šukk+utt-a=tta=m, šukk+utti-a=tta=m	šukkuttattam
šukk-u-a	šukkua
šullūbri	šullūbri
šum-i, šumi-i	šumi
šumali-na=m	šumallam
šumm+a+ni-ne-ž, šumm+a+nni-ž	šummanniž
šumme-ra, šummeri-a	šummera
šummi+n, šummi-n	šummin
šummi+n=nna=m, šummi-n=nna=m, šummi=nna=m	šumminnam
šummi, šummi	šummi
šummi-da	šummida
šummi-da, šummi-ī-da	šummīda
šummi-ne	šummini
šummun-d-id-o=m	šummundidum
šummōnni	šummōnni
šumni-ne-ve	šumunnibi
šumni-ne-ž	šumunnež
šundi+ni-na	šundinna
šupp+a+šše-a=m, šupp+a+šše-a=v	šuppaššab
šur+a+tḫe-ne-ž	šuratḫiniž
šurakk+a+nni-a	šurakkanna
šurb-a, šurbi-a	šurba
šurbigi-na	šurbigina
šurbēgi	šurbēgi
šurr-ā=d	šurrād
šurr-ū	šurrū
šuw+a+ni-na-āž-a	šuwannāža
šuwanilam	šuwanilam
šuġr+ā+že-ne-ž	šuġrāženež
šuġraž+ni-a	šuġražna
šušk-i-b	šuškib
šuʾ-a, šuʾi-a	šuġa
šā+i+šḫe	šāišḫi
šāl-i, šāli	šāli
šāla	šāla
šāla-da	šālada
šālab+ni-i-ra, šālab+ni-ra, šālabniri-a	šālabnira
šālade-ne, šālade-ne-e	šāladeni
šāmani-ne, šāmani-ne-e, šāmanni	šāmanni
šāni-ne-ž	šānnež
šār-a, šār-a, šār-a, šāri-a, šāri-a	šāra
šār-i, šāri	šāri
šāri-a	šara
šāri-b	šārib
šāri-ne-ve	šārinevi
šātt-ed-a	šatteda
šātt-o-m	šattub, šattum, šāttub
šātt-īd-o	šāttīdu
šātt-ō-m	šāttūb
šāv+al-a=m, šāv-al-a=m	šāvalam
šāv+ō+ʾe, šāvō+e	šāvōe
šāġ+ar+i	šāġari
šāġl-i-ēž, šāġli-iē-ž, šāġlē-ž	šāġlēž
šē-al-id-en, šēal-id-en	šēalidin
šēd+oʾ+ilia-ne-ž	šēduilianiž
šēnde+šše-ne, šēnde+šše-ne-e	šēndeššini
šēr-a, šēri-a	šēra
šēr-i, šēri	šēri
šēr-i-a	šēria
šēri-na-āž-a	šerrāža
šēri-ne, šēri-ne-e	šērini
šēri-ne-e	šērri
šēri-ne-n	šerrin
šēri-ne-ē, šēri-nē	šerrē
šēri-ž	šēriž
šērižu	šērižu
šērāmmi	šērāmmi
šēġ+ad+ul+i+m+a+šše-na=ma	šēġadulimaššinama
šēġ-i-āi, šēġa-āi, šīġ-i-ai, šīġi-āi	šīġāi
šēġa, šēġa-a	šēġa
šēġa-n	šēġan
šēġa-ve-na-až-a=an, šēġa-ve-na-až-a=n	šīġāvenažan
šēġa-ā=ttā=ma, šīġ+ātti-ā=ma, šīġ-ā=ttā=ma, šīġ-āt-t-ā=ma, šīġi-ā=ttā=ma	šīġāttāma
šēġal+o+bade-a	šēġalubada
šēġala-na	šēġalana
šēš+še	šēšše
šēž-a, šēži-a, šēžē-a	šēža
šēžē	šēže, šēžie
šī+ni-a, šī-na	šīna
šī-a-šše, šī-i-a-šše	šiašši
šī-b	šib
šī-b, šī-i-b	šīb
šī-ed-i	šīedi
šī-i=l	šīel, šīl
šī-umme-ne, šī-umme-ne-e	šiummeni, šiwummini, šiōmmini
šī-umme-ne, šī-umme-ne-e, šī-ōmme-ne, šī-ōmme-ne-e	šīōmmini
šī-ī=m, šī=m	šīm
šī-ūl-i-lē=m, šīūli-ne-ē=m, šīūli-nē=m	šīwullēm
šī-ūmme-ne, šī-ūmme-ne-e	šīwummini
šīadi	šīadi
šīaiašše	šīaiašši
šīlvi-a	šīelva
šīnunaġi	šīnunaġi
šīr+ni-a, šīr+ni-a, šīrn-a	šīrna
šīr+ni-a=mma	šīrnamma
šīr+ni-b	širnib
šīr-a	šīra
šīr-i, šīr-i, šīri, šīri	šīri
šīrūri-a	šīrūra
šīuġi-a	šīwḫa
šīġ-a, šīġi-a	šīġa
šō+ni, šō+ni-i, šōn-i, šōn-i	šōni
šō+ni-b	šōnib, šūnib
šō+ni-b-a, šō+ni-i-va, šō+ni-va	šōniba
šō+ni-i-a, šōn-i-a	šōnia
šō+ni-i-až	šōniaž
šō+ni-ī-da	šūnīda
šō-i, šō-i, šōe, šōi	šōi
šō-i=ma, šō-i=ma, šōe=ma, šōi=ma	šōima
šōd-ošt-ī-ēž	šōduštiēž
šōe, šōe	šōe
šōe-ne, šōe-ne-e	šōeni
šōe-ne-ve-ne-nna	šōeniveninna
šōl-id-o	šōlidu
šōr+a+šše=lla, šōr-a-šše=lla	šōraššella
šōr-a, šōri-a	šōra
šōr-o-ež, šōri-ož	šōruž
šōri-n, šōri=n	šōrin
šōri-na, šōrr-a, šōrr-a	šōrra
šōġ+a+šše-ne, šōġ+a+šše-ne-e	šōġaššini
šōġoni-na-až-e	šōġunnaži
šōġoni-ne-ž	šuġunnež
šōġori	šōġuri
šōġori-ne, šōġori-ne-e	šōġurri
šūgatte-ne, šūgatte-ne-e	šūgatteni
šūgi	šūgi
šūgē=ma	šūgēma
šūli-a	šūla
šūp-t-a, šūpt-a, šūpti-a	šūpta
šūr+a+nni, šūr-i-anni, šūrani-ne, šūrani-ne-e	šūranni
šūr-i, šūre	šūri
šūr-ō-m	šūrōm
šūr-ōž-i, šūrūže	šūrūži
šūrbē-ne-ž	šūrbēnež
šūre, šūre-ne, šūre-ne-e	šūre
šūrni-ī=ma, šūrnī=ma	šūrnīma
šūw-ar-u-d-a=n=am, šūwarudi-a=n=am	šūwarudanam
šūži-i-ž, šūži-ž	šūžiž
šūḫḫ-ul-ušt-i-b, šūḫḫ-ul-ušt-i=m	šūḫḫuluštib
ūl+me	ulme
ūllu-ž	ūlluž
ūpš-ī-b	ūpšīb
ūrd+a+šše-nē-ž=lla	ūrdaššinēlla
ūrmi	ūrmi
ūrrugi-iffu-we	ūrrugivuwi
ūrġ-ā-b, ūrġ-ā=v, ūrġi-ā=v	ūrġāb
ūrġi	ūrġi
ūrġi-a	urġa
ūšte-ne, ūšte-ne-e	ūšteni
ḫa+i+ġe	ḫaiġi
ḫa-e	ḫāe
ḫa-i, ḫa-i	ḫāi
ḫa-i-b, ḫa-i=m	ḫāib
ḫa-i-b-ā=d, ḫa-i-evā=d	ḫāibād
ḫa-id-e	ḫāide
ḫa-id-en	ḫāiden
ḫa-id-o	ḫaidu
ḫa-iž-i, ḫā+i+že	ḫāiži
ḫa-o-m	ḫāum
ḫa-ol-i+m+āī-n	ḫāulimāīn
ḫa-ol-ill-ānd-o	ḫaulillāndu
ḫa-ož-a	ḫāuža
ḫa-ož-i	ḫāuži
ḫa-ā	ḫāž
ḫa-ā-šše, ḫašši	ḫāšši
ḫa-ā=l	ḫāl
ḫa-ī-b	ḫaīb, ḫāīb
ḫa-ōffu=l	ḫāōppul
ḫab+aḫḫ+ō+bade-a	ḫabaḫḫōbada
ḫabalgi	ḫabalgi
ḫabān-a-b	ḫabānab
ḫademi-ne-n	ḫademinin
ḫal+mi-na-āž-ož	ḫalmināžuž
ḫal+mi-ne-ve	ḫalminibi
ḫalandi	ḫalandi
ḫalba-a=an, ḫalba-a=n, ḫalba=an, ḫalba=n	ḫalban
ḫalikkuli	ḫalikkuli
ḫalz+ō+ġ+li-a	ḫalzōġla
ḫalze	ḫalze, ḫalzi
ḫalze-ne-e	ḫalzēni
ḫalze-ne-ve	ḫalzinibi
ḫam+ar+i-na-až-a, ḫamri-na-až-a	ḫamarraža
ḫam+ar+i-na-až-e-na, ḫamri-na-až-e-na	ḫamarražena
ḫamaz+i+a+šše-dan, ḫamaz+i+a+šše-i-dan	ḫamaziažidan
ḫamri-na	ḫamarra
ḫan+i+re	ḫaniri
ḫan+i+re-na	ḫanirra
ḫan+u+mb+a+sḫe	ḫanumbasḫi
ḫan+u+mb+a+sḫe-da, ḫan+u+mb+a+sḫe-i-da	ḫanumbasḫida
ḫani-ne-ž, ḫanni-ž	ḫanniž
ḫanni-ve-āe, ḫāni-ne-ve-āe	ḫannibāe
ḫapsōri	ḫapsuri, ḫapsōri
ḫapsōri-b	ḫapsurib, ḫapsōrib
ḫapsōri-da, ḫapsōri-i-da	ḫapsōrida
ḫapš-i	ḫāpšī
ḫapš-ār-ūw-a	ḫapšārūwa
ḫarġarai=ma, ḫarġaraima	ḫarġaraima
ḫassizi	ḫassizi
ḫassizi-ai	ḫassizai
ḫassizi-āe	ḫassizāe, ḫāzizāe
ḫassī-n, ḫassī=n	ḫassin
ḫatt+o+ġe	ḫattuġe
ḫatt+o+ġe-na-āž-a	ḫattōġināža
ḫatḫ-ēd-a	ḫatḫēda
ḫauz+o+ġe-a, ḫauz-uġ-a	ḫawsuġa
ḫav+ār+i-ne, ḫavāri-ne-e	ḫavārri
ḫav+āḫḫ+ō+bade-a	ḫavāḫḫōbada
ḫavor+ni	ḫaburni, ḫabōrni, ḫavorni, ḫavōrni
ḫavor+ni-a	ḫaburna
ḫavor+ni-n	ḫaburnin
ḫavor+ni-ne, ḫavor+ni-ne-e	ḫavorunni, ḫavorōnni, ḫavōrunne, ḫavōrunni
ḫavor+ni-ne-e=ma, ḫavor+ni-ne=ma	ḫavorunnima
ḫavor+ni-ne-n	ḫavorunnen, ḫavorunnin, ḫavōrunnin
ḫavor+ni-ne-ne	ḫavōrunnini
ḫavor+ni-ne-ra	ḫāvōrunnīra
ḫavor+ni-ne-va	ḫavōrunniba, ḫāvorunneva
ḫavor+ni-ne-ve	ḫavōrunnibi
ḫavor+ni-ne-ve-na	ḫavōrunnibina
ḫavor+ni-ne-š=nna	ḫavōrunnišša
ḫavor+ni-ož	ḫavōrnuž
ḫavēr+ni	ḫavirni, ḫavērni
ḫaziani-a	ḫaziana
ḫašt+al+i-ne, ḫašt+al+i-ne-e, ḫašt-al-i-le, ḫaštalli	ḫaštalli
ḫaššiadi, ḫaššiadi	ḫaššiadi
ḫaššiadi-na-āž-a	ḫaššiadināža
ḫaž-a, ḫāž-a, ḫāž-a, ḫāži-a	ḫāža
ḫaž-ar-i=nna, ḫāž+ar+i-i-nna, ḫāž+ar+i-nna, ḫāž+ar+i=nna, ḫāž-ar-i=nna	ḫāžarinna
ḫaž-ašt-i-le	ḫažaštili
ḫaž-až-i-b, ḫāž+a+že-b	ḫāžažib
ḫaž-až-i-l-ēž	ḫāžažilēž
ḫaž-až-il-aw=m	ḫažažilaum
ḫaž-i+m+āi	ḫažimāi
ḫaž-i+mm+a(i), ḫaž-i=mma	ḫažimma
ḫaž-ož-a, ḫāž-ož-a	ḫāžuža
ḫaž-ī+m+ai	ḫāžīmai
ḫaž-īd-ō=l	ḫāžīdūl
ḫaž-ōž-a, ḫāž-ōž-a	ḫāžōža
ḫažimari-ne	ḫažimarri
ḫebad, ḫebad	ḫebad
ḫebad-fa	ḫebapta
ḫebad-fe	ḫebapti, ḫebatte
ḫebad-ož	ḫebaduž
ḫebad-ve	ḫebatti
ḫebad-ve-na-až-ož	ḫebattenažuž
ḫebad-ve-na-āž-ōž	ḫebattenāžōž
ḫebad-ve-ne-da	ḫibaptenida
ḫebad-ve-ne-va=l	ḫebatpabnibal
ḫelde-ne, ḫelde-ne-e	ḫeldeni
ḫell+aḫḫ+ō+re	ḫellaḫḫōri
ḫelōvi-a	ḫelōva, ḫēlōva
ḫenni	ḫenni, ḫinni
ḫenni=m	ḫinnim
ḫenni=ma	ḫennēma, ḫinnima, ḫinnēma
ḫenni=mma	ḫinnimma
ḫenni=mma, ḫenni=mma	ḫinimma
ḫenz+ād-u	ḫenzādu
ḫenz-ā, ḫenzi-ā	ḫenzā
ḫenzi-i-da	ḫinzida
ḫer+ār+i	ḫerāri, ḫērāri
ḫeraġi	ḫerāġi
ḫeri, ḫēr-i	ḫēri
ḫeri-da, ḫeri-i-da	ḫerida
ḫeri-ne-ž	ḫerinež
ḫež+āl-a, ḫežāli-a	ḫežāla
ḫi+ar+i-a	ḫiara
ḫi+ar+o+ḫḫe	ḫeiaruḫḫi, ḫiaruḫḫi
ḫi+ar+o+ḫḫe-a	ḫiaruḫḫa
ḫi+ar+o+ḫḫe-na	ḫiaruḫḫina
ḫi+ar+o+ḫḫe-na-āž-a	ḫiaruḫḫināža
ḫiar+o+ni-na	ḫiarunna
ḫiari-ne-ž	ḫiarrež
ḫib-o-l-ēž	ḫibulēž
ḫibar+ni	ḫibarni
ḫide-ne-ve	ḫideneve
ḫil+i+ġe-ne, ḫil+i+ġe-ne-e	ḫiliġini
ḫil-a, ḫili-a	ḫīla
ḫil-id-e, ḫilde	ḫilde
ḫil-ēšt-a, ḫīlēšti-a	ḫīlēšta
ḫild+ār+i-a=lla, ḫild-ār-a=lla	ḫeldāralla
ḫild-a, ḫilde-a	ḫelda
ḫill-am-i-en, ḫill-am-i=n, ḫillame-n, ḫillame=n	ḫillamen
ḫill-am-ōl-a	ḫellamōla
ḫill-ed-i	ḫellidi, ḫillidi
ḫill-i, ḫill-i	ḫilli
ḫill-i-b	ḫellib, ḫillib
ḫill-i-bāde	ḫellibādi
ḫill-i=m	ḫellim
ḫill-ām-ōl-a	ḫellāmōla
ḫill-ē=l	ḫillēl
ḫill-ēd-i	ḫillēdi
ḫimz+a+tḫ-ōž-i, ḫimz+atḫ+ō+že	ḫimzatḫōži
ḫimz-id-o	ḫimzidu
ḫinz-ur-o-l-āe-ž	ḫinzurulāež
ḫinzori-nna	ḫinzurinna, ḫinzōrinna
ḫir+īdi	ḫirīdi
ḫir-aġ-i=lla, ḫiraġe-i=lla	ḫiraġella
ḫiri	ḫiri
ḫiri+ni-ne-e=l, ḫiri+ni-ne=l	ḫirinnel
ḫiv+oll+āde-a, ḫiv-oll-ād-a	ḫivollāda
ḫiž+ar+d+o+ġ+o+li-nē-ve	ḫižarduġullēbi
ḫižm+o+že-a	ḫižmūža
ḫižm-a, ḫižmi-a	ḫižma
ḫižmi-ne, ḫižmi-ne-e	ḫižmini
ḫižmi-ne-ž	ḫežminiž, ḫižmenež
ḫo+i+šše-a	ḫuišša
ḫo+i+šše-ne	ḫuiššeni
ḫomb+ar+ži	ḫōmbārži
ḫowe+ni-i-e=mma, ḫowe+ni-ie=mma, ḫowe-ne-ē=mma, ḫowe-nē=mma	ḫōenēmma
ḫowe+ni-ie-va, ḫowe-nē-va	ḫōenēva
ḫub-ušt-aw	ḫubuštab
ḫubl-i	ḫubli
ḫubni-a	ḫubna
ḫuburi-ne-da=l	ḫuburridal
ḫuburi-ne-va	ḫuburriba
ḫue+ni-i-va=an, ḫue+ni-i-va=n, ḫue+ni-va=an, ḫue+ni-va=n, ḫue-ne-va=an, ḫue-ne-va=n	ḫuenivan
ḫue, ḫō-e, ḫūe	ḫuwe
ḫul-d-i-b, ḫuld-i-b	ḫuldib
ḫull+o+re-va, ḫull+o+re-ē-va, ḫull-ur-i-ēva	ḫullurēva
ḫupp+ad-ed-o, ḫupp+ad-ed-u	ḫuppadedu
ḫupš-i, ḫupši	ḫupši
ḫur+o+šše-ve-na-āž-a	ḫuruššibināža
ḫutḫ-i-ež, ḫutḫi-i-ž, ḫutḫi-ž	ḫutḫiž
ḫutḫi	ḫutḫi
ḫuwava+i=n	ḫuwavain
ḫušte-na-āž-a	ḫuštenāža
ḫāb+o+že-b	ḫābužib, ḫābōžib
ḫāigali-ne, ḫāigali-ne-e	ḫāigalli
ḫāl-i-l-āi	ḫāllāi
ḫālōli	ḫālōli
ḫān+u+b+a+sḫe	ḫanubasḫi, ḫānubasḫi
ḫān-i, ḫāni	ḫāni
ḫāni-i-e, ḫāni-i-e, ḫāni-ie	ḫānie
ḫāni-ve-āe	ḫanibāe
ḫār+a+ġe-ve-aē=m	ḫārapḫaēm
ḫār+a+ġe-ve-āi	ḫārāpḫāi
ḫār+a+ġe-ve-āī=m	ḫārapḫāīm
ḫār+a+ġe-ve-āī=v	ḫārapḫāīb
ḫār-a, ḫāri-a	ḫāra
ḫār-i, ḫāri	ḫāri
ḫār-i-le, ḫāri-ne, ḫāri-ne-e	ḫārri
ḫāri-a	ḫara
ḫāri-ie-ne, ḫārē-ne, ḫārē-ne-e	ḫārēni
ḫāri-na, ḫāri-na	ḫārra
ḫāri-na-až-a	ḫarraža
ḫāri-na-až-ane=lla	ḫarražanilla
ḫāri-ne-ē=ma, ḫāri-nē=ma	ḫārrēma
ḫāru+i, ḫāruwi	ḫāruwi
ḫāv+ō+že-na	ḫāvōžina
ḫāġi-p-pe-na=ma	ḫāġippinama
ḫāž+ar+i	ḫažari, ḫažāri, ḫāžari
ḫāž+ar+i, ḫāž-ār-i	ḫāžāri
ḫāž+ar+i-a	ḫažara, ḫāžara
ḫāž+ar+i-ae	ḫāžarae
ḫāž+ar+i-ne-e	ḫažarri
ḫāž+ar+i-ne-e, ḫāž+arri, ḫāž+arri-ž	ḫāžarri
ḫāž+ar+i-ne-ž, ḫāž+arri-ž	ḫažarrež
ḫāž+ar+i-nē-ž	ḫāžarrie
ḫāž+ar+i-āe	ḫažarāe, ḫāžarāe
ḫāž+ar+i-āi	ḫāžarāi
ḫāž+arri-da=l	ḫāžarridal
ḫāž+arri-āe	ḫažarrāe
ḫāž+arri-āi	ḫažarrāi
ḫāž+arri-ž	ḫāžarrī
ḫāž+arri=ma	ḫāžarrima
ḫāž+až+i+mmi	ḫāžažimmi
ḫāž-ind-o-ež	ḫāžinduž
ḫāž-o, ḫāž-u	ḫāžu
ḫāž-o-l-ēž	ḫāžulēž
ḫāžeri-a	ḫāžēra
ḫāžeri-āe	ḫāžerāe
ḫāži+mmi-ie, ḫāži+mmē	ḫāžimmie
ḫāži-āe	ḫažāe
ḫāḫḫi-ne-ž	ḫāḫḫiniž
ḫē-ar-ašt-ēd-a	ḫēaraštēda
ḫēbādu-we	ḫēbādōi
ḫēl-išt-o, ḫēl-išt-u	ḫēlištu
ḫēr	ḫeēr
ḫēġ+ō+že	ḫēġōži
ḫīd-ūr-i, ḫīdūri	ḫīdūri
ḫīdam	ḫīdam
ḫīri-i-a	ḫīria
ḫīž+ār+i, ḫīž-ār-i	ḫīžāri
ḫō+i+ġe-i-a	ḫōiġia
ḫō+i+ġe-ia-ne	ḫōiġiani
ḫō+ī+tḫe-a	ḫōītḫa
ḫō-i	ḫōi
ḫō-i-le	ḫōili
ḫō-i=lla	ḫōiella
ḫō-id-en	ḫōidan
ḫō-id-o	ḫōidu
ḫō-ož-ill-i-āi-n, ḫō-ož-ill-i-āi=n, ḫōž-il-i-l-āi-n, ḫōž-il-i-l-āi=n, ḫōž-ill-i-āi-n, ḫōž-ill-i-āi=n	ḫōžellāin
ḫō-ī-b	ḫōīb
ḫōb+idi	ḫōbidi
ḫōb+idi, ḫōb-ēd-i	ḫōbēdi
ḫōb-i-ež, ḫōbi-ž	ḫōbiž
ḫōb-ān-a-b, ḫōb-ān-a-b	ḫōbānab
ḫōbidōdi-a	ḫōbidōda
ḫōbri	ḫōbri
ḫōbri-a	ḫōbra
ḫōbri-b	ḫōbrib
ḫōd+a+nn+ar+a+že-āe	ḫōdannaražāe
ḫōd+a+nn+ar+a+že-āi	ḫōdannaražāi
ḫōd+a+nni	ḫōdanni
ḫōd+a+nni-a, ḫōd+a+nni-na	ḫōdanna
ḫōd+a+nni-da, ḫōd+a+nni-i-da	ḫōdannida
ḫōd+a+nni-ve-āe	ḫōdannibāe
ḫōd+a+nni-āe	ḫōdannāe
ḫōd-ed-aw	ḫudidaw
ḫōd-i+m+ae	ḫōdemae
ḫōd-i+m+ae-n	ḫōdedemaen
ḫōd-id-o=m	ḫōttum
ḫōd-ud-id-o=m	ḫōduttum
ḫōd-ur-o-m	ḫōdurum
ḫōd-ō=ma	ḫōdōma
ḫōde-na	ḫōdena
ḫōde-na-až-e	ḫōdinaži
ḫōde-na-až-e-āi	ḫōdenažāi
ḫōde-na-až-ož	ḫōdenažuž
ḫōde-na-āž-a	ḫudenāža
ḫōde-na-āž-ož	ḫōdenāžuž
ḫōde-na-āž-ōž	ḫōdenāžōž
ḫōde-ž	ḫōdež
ḫōdellori-na-až-ož	ḫōdellurražuž
ḫōdri-a	ḫōdra
ḫōl-ol-id-o	ḫōlulidu
ḫōl-āmm-i, ḫōlā+mmi	ḫōlāmmi
ḫōlel+zi-da, ḫōlel+zi-i-da	ḫōlelzida
ḫōlli-i-až	ḫōlliaž
ḫōm+ar+o+ḫḫe-na	ḫōmaruḫḫina
ḫōm+ar+o+ḫḫe-na-āž-a	ḫōmmāruḫḫināža
ḫōm+ar+o+ḫḫe-na=an	ḫumaruġinan
ḫōmari, ḫōmari	ḫōmari
ḫōmari-da	ḫōmarida
ḫōmari-ne-ne=n, ḫōmarri-ne-n	ḫōmarrinin
ḫōmn-umme	ḫōmnummi
ḫōmni	ḫōmni
ḫōnži-ne, ḫōnži-ne-e	ḫōnžini
ḫōp-id-en, ḫōp-t-i-en, ḫōpt-i-en, ḫōpte-n, ḫōpte=n	ḫōpten
ḫōpši-ne-va	ḫōpšineva
ḫōr+o+vāde-a	ḫōruwāda
ḫōr-upp-i, ḫūruffe	ḫōruppi
ḫōr-ām-i, ḫōrāmi	ḫōrāmi
ḫōra-i-da=n	ḫōraidan
ḫōra-ī-a	ḫōraīa
ḫōrdi	ḫōrdi
ḫōri-da, ḫōri-i-da	ḫōrida
ḫōri-i-da	ḫurida
ḫōri-na-až-a	ḫōrraža
ḫōri-na-až-a=lla	ḫōrražalla
ḫōrr-ošt-āw	ḫōrruštāw
ḫōrušši-a	ḫōruššia
ḫōrv+āde	ḫōrvāde
ḫōrvi-ne, ḫōrvi-ne-e	ḫōrvini
ḫōuni	ḫōni
ḫōš-t-i, ḫōšt-i, ḫōšti, ḫōšti	ḫōšti
ḫōšti-iffu-we=m, ḫōšti-iffu-wā=m	ḫōštivuwām
ḫōšši-ne-e	ḫōššini
ḫōž-i-a	ḫōžia
ḫōž-ill-and-i-n, ḫōž-ill-and-i=n	ḫōžellandin
ḫōž-oš-t-a, ḫōž-ušt-a	ḫužušta
ḫōž-un-i, ḫōžuni	ḫōžuni
ḫōž-uw-a, ḫōž-uw-a	ḫōžuwa
ḫōž-ān-ōl-a	ḫōžānōla
ḫōž-ī-o, ḫōž-ī-o	ḫōžīw
ḫōž-ūw-a	ḫužūwa
ḫōžuri-na-až-a	ḫōžurraža
ḫūruffe-ne-e	ḫūruffeni
ḫūž-i-a, ḫūži-i-a	ḫūžia
